border_size=1
usage=map

Ke          , Ke          , Ke          , Ke          , Ke          , Ke          , Ke          , Ke          , Ke          , Ke          , Ke          , Ke          , Ke          , Ke          , Ke          , Ke          , Rrc         , Ke          , Wwt         , Ke          , Ke          , Ke          , Ke          , Ke          , Ke          , Ke          , Ke          , Ke          , Ke          , Ke          
Ke          , Ke          , Ke          , Ke          , Ke          , Ke          , Ke          , Ke          , Ke          , Ke          , Ke          , Ke          , Ke          , Ke          , Ke          , Ke          , Rrc         , Ke          , Wwt         , 2 Ke        , Ke          , Ke          , Ke          , Ke          , Ke          , Ke          , Ke          , Ke          , Ke          , Ke          
Gg          , Gg          , Gg          , Re^Vct      , Gg          , Gg          , Rb          , Gg          , Gg          , Re^Vct      , Gg          , Gg          , Gg          , Gg          , Gg          , Re^Vct      , Rrc         , Gg          , Wwf         , Gg          , Gg          , Re^Vct      , Gg          , Gg          , Gg          , Re^Vct      , Gg          , Gg          , Gg          , Gg          
Gg          , Gg          , Gs          , Gg          , Gg          , Gg          , Rb          , Gg          , Gg          , Gg          , Gs          , Gs          , Gg          , Gg          , Gs          , Gg          , Rrc         , Gg          , Wwf         , Gg          , Gg          , Gg          , Gg          , Gg          , Gg          , Gg          , Gg          , Gg          , Ch          , Gg          
Gg          , Gg          , Gg          , Gg          , Gg          , Gg          , Rb          , Gg          , Gg          , Gs          , Gs          , Gs          , Gg          , Gg          , Gg          , Gg          , Rrc         , Gg          , Wwf         , Gg          , Gg^Ve       , Gg          , Gg          , Gg          , Gg          , Gg          , Ch          , Gg          , Gg^Efm      , Ch          
Hh          , Gg          , Gg          , Gs^Vh       , Gg          , Gg          , Rb          , Rb          , Rb          , Gg          , Gd^Vo       , Gg          , Gll^Fp      , Gll^Fp      , Gll^Fp      , Gg          , Rrc         , Gg          , Gg          , Wwt         , Wwt         , Gg          , Gg          , Gg          , Gg          , Ch          , Rr^Vd       , Gg^Efm      , Rrc         , Rrc         
Hh          , Hh          , Gg          , Gg          , Rb          , Rb          , Rb^Gvs      , Rb^Gvs      , Rb^Gvs      , Rb          , Rb          , Gg          , Gll^Fp      , Hh^Fp       , Rb          , Hh^Vhh      , Gll^Fp      , Rrc         , Rrc         , Gg          , Wwt         , Gg          , Ch          , Ch          , Rrc         , Rrc         , Rrc         , Rrc         , Xos         , Xos         
Hh          , Hh          , Gg          , Rb          , Rb^Gvs      , Rb^Gvs      , Rb^Gvs      , Rb^Gvs      , Rb^Gvs      , Rb^Gvs      , Rb^Gvs      , Gll^Fp      , Hh          , Gll^Fp      , Rb          , Hh^Fp       , Gll^Fp      , Gg          , Gg          , Rrc         , Wwt^Bsb\    , Gg          , Rrc         , Rrc         , Gg^Efm      , Gg^Efm      , Xos         , Rb          , Iwr         , Xos         
Hh          , Hh          , Gg          , Rb          , Rb^Gvs      , Rb^Gvs      , Rb^Gvs      , Rb^Gvs      , Rb^Gvs      , Rb^Gvs      , Hh^Wm       , Hh          , Mm          , Hh^Fp       , Rb          , Hh          , Hh          , Gll^Fp      , Gg          , Gg          , Wwt         , Rrc         , Gg^Fet      , Gg^Efm      , Xos         , Xos         , Iwr         , Iwr         , Iwr         , Iwr         
Hh          , Hh          , Gg          , Rb          , Rb^Gvs      , Rb^Gvs      , Rb^Gvs      , Rb^Gvs      , Rb^Gvs      , Rb^Gvs      , Rb^Gvs      , Hh          , Hh          , Hh^Fp       , Rb          , Hh          , Gll^Fp      , Gll^Fp      , Gg          , Gg          , Wwt^Bsb/    , Rrc         , Rrc         , Gg^Efm      , Gg^Efm      , Xos         , Xos         , Iwr         , Iwr         , Iwr         
Hh          , Hh          , Gg          , Rb          , Rb          , Rb^Gvs      , Rb^Gvs      , Rb^Gvs      , Rb^Gvs      , Rb^Gvs      , Rb          , Gll^Fp      , Gll^Fp      , Gll^Fp      , Rb          , Hh^Fp       , Gll^Fp      , Gg          , Rrc         , Rrc         , Wwt         , Gg          , Ch          , Rrc         , Rrc         , Gg^Efm      , Rrc         , Rb          , Xos         , Xos         
Hh          , Hh          , Gg          , Gg          , Gg          , Rb          , Rb          , Rb^Gvs      , Rb          , Rb          , Gd^Vo       , Gg          , Hh^Fp       , Hh^Fp       , Gll^Fp      , Hh^Vhh      , Rrc         , Rrc         , Gg          , Gg          , Wwt         , Gg          , Gg          , Ch          , Gg          , Rrc         , Rr^Vd       , Rrc         , Rrc         , Xos         
Gg          , Gg          , Gg          , Gs^Vh       , Gg          , Gg          , Rb          , Rb          , Gg          , Gg          , Gg          , Gg          , Gg          , Hh^Fp       , Gg          , Gg          , Rrc         , Gg          , Wwf         , Wwt         , Gg^Ve       , Gg          , Gg          , Gg          , Gg          , Ch          , Ch          , Gg^Efm      , Gg^Efm      , Rrc         
Gg          , Gg          , Gg          , Gg          , Gg          , Gg          , Rb          , Gg          , Gg          , Gg          , Gs          , Gs          , Gg          , Gg          , Gg          , Gg          , Rrc         , Gg          , Wwf         , Gg          , Gg          , Gg          , Gg          , Gg          , Gg          , Gg          , Gg          , Gg          , Ch          , Ch          
Gg          , Gg          , Gg          , Gs          , Gg          , Gg          , Rb          , Gg          , Gg          , Gs          , Gg          , Gs          , Gg          , Gs          , Gg          , Gg          , Rrc         , Gg          , Wwf         , Gg          , Gg          , Gg          , Gs          , Gs          , Gg          , Gg          , Gg          , Gg          , Gg          , Gg          
Gg          , Gg          , Re^Vct      , Gg          , Gg          , Gg          , Rb          , Gg          , Re^Vct      , Gg          , Gg          , Gg          , Gg          , Gg          , Re^Vct      , Gg          , Rrc         , Gg          , Wwt         , Gg          , Re^Vct      , Gg          , Gg          , Gg          , Gg          , Gg          , Re^Vct      , Gg          , Gg          , Gg          
Ke          , Ke          , Ke          , Ke          , Ke          , Ke          , Ke          , Ke          , Ke          , Ke          , Ke          , Ke          , Ke          , Ke          , Ke          , Ke          , Rrc         , Ke          , Wwt         , 1 Ke        , Ke          , Ke          , Ke          , Ke          , Ke          , Ke          , Ke          , Ke          , Ke          , Ke          
Ke          , Ke          , Ke          , Ke          , Ke          , Ke          , Ke          , Ke          , Ke          , Ke          , Ke          , Ke          , Ke          , Ke          , Ke          , Ke          , Rrc         , Ke          , Wwt         , Ke          , Ke          , Ke          , Ke          , Ke          , Ke          , Ke          , Ke          , Ke          , Ke          , Ke          
