border_size=1
usage=map

Gs^Fms      , Gs^Fms      , Gs^Fms      , Wwf         , Gs^Fms      , Gs^Fms      , Gs^Fms      , Gs^Fms      , Gs^Fms      , Gs^Fms      , Gs^Fms      , Gs^Fms      , Gs^Fms      , Gs^Fms      , Gs^Fms      , Gs^Fms      , Gs^Fms      , Gs^Fms      , Gs^Fms      , Gs^Fms      , Gs^Fms      , Gs^Fms      , Gs^Fms      , Gs^Fms      , Gs^Fms      , Gs^Fms      , Re^Fms      , Gs^Fms      , Gs^Fms      , Gs^Fms      , Gs^Fms      , Re^Fms      , Wwf         , Wwf         , Wwf         , Gg          , Hh          , Hh          , Hh          , Hh          , Mm          , Mm          , Wog         , Wog         , Wog         , Wog         
Gs^Fms      , Gs^Fms      , Gs^Fms      , Wwf         , Wwf         , Gs^Fms      , Gs^Fms      , Gs^Fms      , Gs^Fms      , Gs^Fms      , Gs^Fms      , Gs^Fms      , Gs^Fms      , Gs^Fms      , Gs^Fms      , Gs^Fms      , Rb^Fms      , Gs^Fms      , Gs^Fms      , Gs^Fms      , Gs^Fms      , Gs^Fms      , Gs^Fms      , Gs^Fms      , Gs^Fms      , Gs^Fms      , Re^Fms      , Gs^Fms      , Gs^Fms      , Gs^Fms      , Re^Fms      , Re^Fms      , Gs^Fms      , Wwf         , Wwf         , Hh          , Mm          , Mm          , Mm          , Mm          , Hh          , Wog         , Wog         , Wog         , Wog         , Wog         
Gs^Fms      , Gs^Fms      , Gs^Fms      , Re^Fms      , Gs^Fms      , Wwf         , Re^Fms      , Gs^Fms      , Re^Fms      , Re^Fms      , Re^Fms      , Re^Fms      , Gs^Fms      , Gs^Fms      , Gs^Fms      , Gs^Fms      , Rb^Fms      , Rb^Fms      , Gs^Fms      , Gs^Fms      , Gs^Fms      , Gs^Fms      , Rb^Fms      , Gs^Fms      , Rb^Fms      , Re^Fms      , Re^Fms      , Re^Fms      , Gs^Fms      , Gs^Fms      , Rb          , Rb          , Rb          , Wwf         , Wwf         , Ch          , Ch          , 2 Kh        , Ch          , Ch          , Wwg         , Wwg         , Wwg         , Wog         , Wog         , Wog         
Gs^Fms      , Gs^Fms      , Gs^Fms      , Gs^Fms      , Gs^Fms      , Wwf         , Gs^Fms      , Gs^Fms      , Re^Fms      , Re^Fms      , Gs^Fms      , Gs^Fms      , Gs^Fms      , Gs^Fms      , Gs^Fms      , Gs^Fms      , Gs^Fms      , Rb^Fms      , Gs^Fms      , Gs^Fms      , Gs^Fms      , Gs^Fms      , Rb^Fms      , Rb^Fms      , Gs^Fms      , Gs^Fms      , Rb          , Gs^Fms      , Rb          , Rb          , Rb          , Gs^Fms      , Gs^Fms      , Wwf         , Wwf         , Wwf         , Wwf         , Ch          , Wwf         , Wwf         , Wwf         , Wwg         , Mm          , Mm          , Mm          , Mm          
Gs^Fms      , Gs^Fms      , Gs^Fms      , Gs^Fms      , Gs^Fms      , Wwf         , Wwf         , Gs^Fms      , Gs^Fms      , Gs^Fms      , Re^Fms      , Gs^Fms      , Gs^Fms      , Gs^Fms      , Gs^Fms      , Gs^Fms      , Rb          , Gs^Fms      , Rb          , Gs^Fds      , Rb          , Rb^Fms      , Rb          , Gs^Fms      , Rb          , Rb          , Ke          , Rb          , Re^Vct      , Rb          , Rb          , Gs^Fms      , Hh^Fds      , Mm          , Ss          , Wwf         , Wwf         , Wwf         , Wwf         , Wwf         , Wwf         , Mm          , Hh          , Mm          , Hh          , Hh          
Gs^Fms      , Gs^Fms      , Rb^Fms      , Gd^Fms      , Gs^Fms      , Gs^Fms      , Wwf         , Gs^Fms      , Re^Fms      , Re^Fms      , Re^Fms      , Re^Fms      , Gs^Fms      , Gs^Fms      , Rb          , Rb          , Ke          , Rb          , Gs^Fms      , Rb          , Re^Vct      , Rb          , Gs^Fms      , Rb          , Ke          , Ke          , Gs^Fms      , Re^Fms      , Re^Fms      , Re^Fms      , Rb          , Gs^Fms      , Hh          , Hh          , Ss          , Hh          , Wwg         , Wwf         , Wwf         , Wwf         , Gg          , Hh          , Hh          , Hh          , Hh          , Hh          
Gs^Fms      , Gs^Fms      , Rb^Fms      , Rb^Fms      , Rb^Fms      , Rb^Fms      , Wwf         , Gs^Fms      , Gs^Fms      , Gs^Fms      , Gs^Fms      , Gs^Fms      , Re^Vct      , Gs^Fms      , Rb          , Ke          , Ke          , Gs^Fms      , Re^Fms      , Gs^Fms      , Gs^Fms      , Gs^Fms      , Gs^Fms      , Gs^Fms      , Hh          , Gs^Fms      , Hh          , Hh          , Hh          , Gs^Fms      , Rb          , Gs^Fms      , Hh          , Ss          , Re^Vct      , Hh          , Wwg         , Wwg         , Wwf         , Gg          , Gg          , Gg          , Gs^Efm      , Gs          , Gs          , Hh          
Gs^Fms      , Gs^Fms      , Gs^Fms      , Gs^Fms      , Rb^Fms      , Gs^Fms      , Wwf         , Rb^Fms      , Gs^Fms      , Gs^Fms      , Rb          , Rb          , Rb          , Rb          , Re^Fms      , Gs^Fms      , Gs^Fms      , Gs^Fms      , Gs^Fms      , Gs^Fms      , Mm          , Hh          , Hh          , Hh          , Hh          , Mm          , Mm          , Mm          , Gs          , Gs          , Rb          , Gg          , Ss          , Ss          , Rb          , Hh^Fds      , Wog         , Wwg         , Gg          , Gg^Vh       , Gs          , Gs          , Gs          , Gs^Efm      , Gs          , Gs          
Gs^Fms      , Gs^Fms      , Gs^Fms      , Gs^Fms      , Rb^Fms      , Gs^Fms      , Rb^Fms      , Wwf         , Wwf         , Rb          , Gs^Fms      , Rb          , Gs^Fms      , Gs^Fms      , Gs^Fms      , Re^Fms      , Re^Fms      , Gs^Fms      , Hh          , Hh          , Hh          , Hh          , Gs          , Gs          , Gs          , Gs          , Gs          , Gs          , Gs          , Gs          , Rb          , Gg          , Gg          , Ss^Bw/      , Ss          , Wwg         , Wog         , Wwg         , Gg          , Gg          , Gs          , Gs          , Gs          , Gs          , Gs          , Gs          
Gs^Fms      , Gs^Fms      , Re^Fms      , Gs^Fms      , Rb^Fms      , Rb^Fms      , Gs^Fms      , Gs^Fms      , Rb          , Wwf         , Wwf         , Gs^Fms      , Gs^Fds      , Gs^Fms      , Gs^Fms      , Re^Fms      , Gg          , Hh          , Gs          , Gs          , Gs^Vht      , Gs          , Rb          , Rb          , Rb          , Gs^Efm      , Gs          , Gs^Vht      , Rb          , Rb          , Gs^Efm      , Gs          , Ce          , Ke          , Ds          , Wwg         , Wog         , Wwg         , Gg          , Gg          , Gs          , Gs^Efm      , Gs^Efm      , Gs^Efm      , Gs          , Gs          
Gs^Fms      , Gs^Fms      , Re^Fms      , Gs^Fms      , Gs^Fms      , Gs^Fms      , Gs^Fms      , Rb          , Rb^Fms      , Gs^Fms      , Wwf         , Gs^Fds      , Wwf         , Wwf         , Wwf         , Gg          , Gg          , Gs          , Gs          , Gs          , Rb          , Rb          , Gs          , Gs^Efm      , Gs          , Rb          , Rb          , Rb          , Gs^Efm      , Gs^Efm      , Gs          , Gs          , Ds          , Ds          , Ds          , Wwg         , Wog         , Wwg         , Gg          , Gg          , Gs          , Gs          , Gs          , Gs          , Gs          , Gs          
Gs^Fms      , Gs^Fms      , Gs^Fms      , Gs^Fms      , Gs^Fds      , Gs^Fms      , Gs          , Rb          , Gs          , Gg          , Gg          , Wwf         , Gg          , Gg          , Gg          , Wwf         , Wwf         , Gg          , Rb          , Rb          , Gs          , Gs          , Gg          , Gs          , Gg          , Gs          , Rb          , Gs          , Gg          , Gs^Efm      , Ds          , Ds          , Ds          , Ds          , Wwg         , Wwg         , Wwg         , Wwg         , Gg          , Gg          , Gs          , Gs^Efm      , Gs^Efm      , Gs^Vht      , Gs          , Gs          
Gs^Fms      , Gs^Fms      , Rb^Fms      , Gs^Fms      , Gs          , Gs          , Rb          , Rb          , Gs          , Gs          , Hh          , Gg          , Hh          , Hh          , Gs          , Gg          , Rb          , Wwf         , Wwf         , Gg          , Gg          , Gg          , Gg          , Gg          , Wwg         , Gg          , Rb          , Gg          , Ds          , Ds          , Ds          , Ds          , Wwg         , Wwg         , Wwg         , Wwg         , Ss          , Ce          , Ce          , Gs          , Gs          , Gs^Efm      , Gs^Efm      , Gs          , Gs          , Gs          
Gs^Fms      , Gs^Fms      , Gs^Fms      , Gs^Fms      , Gs          , Gs^Vd       , Rb          , Gs          , Gs          , Hh          , Mm          , Mm          , Hh          , Hh          , Gs          , Rb          , Gs          , Ss          , Gs^Fds      , Wwf         , Wwf         , Gg^Fet      , Wwg         , Wwg         , Wwg         , Wwg         , Wwg^Bw|     , Ds          , Wwg         , Wwg         , Wwg         , Wwg         , Wwg         , Wwg         , Gs^Fds      , Gs^Fds      , Ss          , Ce          , Gs^Fds      , Ke          , Gs          , Gs          , Gs          , Gs          , Gs          , Gs          
Re^Fms      , Re^Fms      , Ce          , Gs          , Rb          , Rb          , Gs          , Gs          , Hh          , Hh          , Hh          , Hh          , Ke          , Ce          , Gs          , Rb          , Gs          , Ss^Vhs      , Gs^Fds      , Gs^Fds      , Wwg         , Wwg         , Wwg         , Wwg         , Ds          , Wwg         , Wwg^Bw|     , Wwg         , Wwg         , Wog         , Wwg         , Wwg         , Gs^Fds      , Ss          , Rb          , Rb          , Ss          , Gs^Fds      , Gs^Fds      , Gs          , Gs          , Gs          , Gs          , Gs          , Gs          , Gs          
Gs^Fms      , Re^Fms      , Ke          , Gs          , Rb          , Gs          , Hh          , Hh          , Mm          , Mm          , Hh          , Ce          , Ce          , Ce          , Gs          , Rb          , Gg          , Ss          , Wwg         , Wwg         , Wwg         , Wwg         , Ds          , Ds          , Gs          , Ds          , Cv          , Wwg         , Ss          , Wwg         , Gs^Fds      , Gs^Fds      , Ss          , Ss^Vm       , Ss          , Gs^Fds      , Ss          , Gs^Fds      , Gg          , Gs          , Gs^Efm      , Gs          , Gs          , Gs          , Rrc         , Rrc         
Gs^Fms      , Gs^Fms      , Ce          , Gs          , Rb          , Hh          , Hh          , Mm          , Hh          , Hh          , Gs          , Gs          , Gs          , Gs          , Rb          , Rb          , Gs^Fds      , Wwg         , Wog         , Wwg         , Ds          , Ss          , Gg          , Gs          , Gs          , Cv          , Kv          , Cv          , Gs^Fds      , Ss          , Ss          , Ss          , Ss          , Ss          , Gs^Fds      , Ss          , Gg          , Gg          , Gs          , Gs^Vht      , Gs          , Gs          , Rrc         , Rrc         , Gs^Fds      , Gs^Fds      
Gs^Fms      , Gs^Fms      , Hh          , Hh          , Rb          , Hh          , Hh          , Hh          , Gs          , Gs^Vht      , Gs          , Gs          , Gs^Efm      , Rb          , Gs          , Gs^Fds      , Gs^Fds      , Wwg         , Wwg         , Wwg         , Ds          , Ss          , Gg          , Gs          , Gs          , Cv          , Cv          , Cv          , Rb          , Gs^Fds      , Gs^Fds      , Gs^Fds      , Gs^Fds      , Gs^Fds      , Gg          , Gg          , Gs          , Gs          , Gs          , Gs          , Rrc         , Rrc         , Gg^Eff      , Gs^Fds      , Gs^Fds      , Gs^Fds      
Hh          , Hh          , Mm          , Hh          , Rb          , Hh          , Gs          , Gs          , Gs          , Gs          , Gs          , Gs          , Rb          , Rb          , Gs          , Gs^Fds      , Gs^Fds      , Wwg         , Wwg         , Ds          , Gg          , Ss          , Ss          , Gg          , Gs          , Gs          , Gs          , Gs          , Gs          , Rb          , Rb          , Gs          , Gs          , Gs          , Rb          , Rb          , Rb          , Gs          , Rrc         , Rrc         , Gg^Eff      , Gg^Eff      , Gg          , Gs^Fds      , Gs^Fds      , Gs^Fds      
Mm          , Mm          , Mm          , Hh          , Hh          , Rb          , Rb          , Gs          , Gs^Efm      , Gs          , Rb          , Rb          , Gs          , Gs          , Gs^Efm      , Gs^Fds      , Gs^Fds      , Wwg         , Wwg         , Ds          , Gg          , Ss^Vm       , Ss          , Gg          , Gs          , Gs          , Gs^Efm      , Gs^Efm      , Gs          , Gs          , Gs^Vht      , Rb          , Rb          , Rb          , Ce          , Ke          , Rrc         , Rrc         , Rrc         , Gg^Eff      , Gg^Vh       , Gg          , Rrc         , Gg          , Gg          , Gs^Fds      
Mm          , Mm          , Mm          , Mm          , Mm          , Hh          , Hh          , Rb          , Rb          , Rb          , Rb          , Gs^Efm      , Gs          , Gs          , Gs^Vht      , Gs^Fds      , Gs^Fds      , Wwg         , Wwg         , Wwg         , Ss          , Ss          , Gg          , Gg          , Gs          , Gs^Efm      , Gs          , Gs          , Gs          , Gs          , Rb          , Rb          , Gs          , Gs          , Rrc         , Rrc         , Gg^Eff      , Gg^Eff      , Gg          , Rrc         , Rrc         , Rrc         , Rrc         , Rrc         , Rrc         , Gs^Fds      
Mm          , Mm          , Mm          , Mm          , Mm          , Hh          , Gs^Vht      , Gs          , Gs^Efm      , Rb          , Rb          , Gs          , Gs          , Gs          , Gs^Efm      , Gs^Efm      , Gs^Fds      , Ds          , Wwg         , Wwg         , Hh          , Gg          , Gs          , Gs          , Gs          , Gs          , Gs^Fds      , Hh          , Gs^Fds      , Rb          , Gs          , Gs          , Rrc         , Rrc         , Hh^Fds      , Gg^Eff      , Gg          , Gg          , Rrc         , Rrc         , Rrc         , Rrc         , Rrc         , Rrc         , Gg          , Gg          
Wwf         , Mm          , Mm          , Mm          , Hh          , Hh          , Gs          , Gs          , Gs          , Gs          , Gs          , Rb          , Rb          , Gs          , Gs^Efm      , Gs          , Gs^Fds      , Ds          , Wwg         , Wwg         , Hh          , Gs          , Gs          , Gs^Efm      , Gs          , Gs^Fds      , Hh^Fds      , Hh^Fds      , Gs^Fds      , Rb          , Gs          , Gs          , Rrc         , Gs^Fds      , Hh^Fds      , Gg          , Rrc         , Rrc         , Rrc         , Rrc         , Rrc         , Rrc         , Gg          , Gg          , Gs^Fds      , Gs^Fds      
Mm          , Wwf         , Wwf         , Hh          , Gs          , Gs          , Gs^Efm      , Gs          , Gs          , Gs          , Gs          , Ke          , Rb          , Gs          , Gs          , Gs^Fds      , Ds          , Ds          , Wwg         , Wwg         , Hh          , Hh^Vhh      , Gs          , Gs          , Gs          , Gs^Fds      , Hh          , Gs^Fds      , Gs          , Rb          , Gs          , Gs          , Rrc         , Gs^Fds      , Hh^Fds      , Gs^Fds      , Rrc         , Rrc         , Rrc         , Rrc         , Cd          , Ds          , Ds^Vda      , Gs^Fds      , Gs^Fds      , Gs^Fds      
Mm          , Mm          , Hh          , Wwf         , Wwf         , Gs^Efm      , Wwf         , Gs          , Gg          , Gs          , Gs          , Ce          , Ce          , Rb          , Rb          , Gs^Fds      , Wwg         , Wwg         , Wwg         , Wwg         , Hh          , Gs          , Gs          , Gs^Efm      , Gs          , Gs          , Gs          , Gs          , Rb          , Rb          , Gs          , Gs          , Rrc         , Hh^Fds      , Hh^Fds      , Gs^Fds      , Gg          , Rrc         , Cd          , Cd          , Ds^Esd      , Ds          , Gs^Fds      , Gs^Fds      , Gs^Fds      , Hh^Fds      
Hh          , Hh          , Gs^Fds      , Gs          , Gs          , Wwf         , Gs          , Wwf         , Wwf         , Gg          , Gg          , Ce          , Wwg         , Gs^Fds      , Wwg         , Wwg^Bw\     , Wwg^Bw\     , Wwg         , Hh          , Hh          , Gs          , Gs          , Gs^Efm      , Gs          , Gs          , Gs          , Rb          , Rb          , Gs          , Gs          , Gs^Vht      , Gs          , Rrc         , Hh^Fds      , Hh^Fds      , Gs^Fds      , Cd          , Ds          , Ds          , Kd          , Ds          , Ds^Dr       , Gs^Fds      , Gs^Fds      , Gs^Fds      , Hh^Fds      
Gs^Fds      , Gs^Fds      , Gs^Fds      , Gs          , Gs          , Gs          , Gg^Vh       , Gs^Fds      , Ss          , Wwf         , Wwg         , Wwg         , Wog         , Wwg         , Wwg         , Wwg         , Gs^Fds      , Rb          , Rb          , Gs          , Gs          , Gs^Efm      , Gs          , Gs          , Rb          , Rb          , Ce          , Gs          , Gs          , Gs^Efm      , Gs          , Gs          , Rrc         , Gs^Fds      , Hh^Fds      , Gg^Efm      , Gg^Efm      , Cd          , Cd          , Ds          , Ds          , Gs^Fds      , Gs^Fds      , Gs^Fds      , Hh^Fds      , Hh^Fds      
Gs^Fds      , Gs^Fds      , Gs          , Gs^Efm      , Gs          , Gs          , Gg          , Ss          , Ss          , Gs^Fds      , Wwg         , Wog         , Wwg         , Wwg         , Wwf         , Ds          , Ds          , Gs^Fds      , Gs^Efm      , Rb          , Rb          , Gs          , Rb          , Rb          , Gs          , Ce          , Ke          , Ce          , Gs          , Gs          , Gs          , Gs          , Rrc         , Gs^Fds      , Hh^Fds      , Hh^Fds      , Gg^Efm      , Gg^Efm      , Gg^Efm      , Cd          , Gg^Efm      , Gs^Fds      , Gs^Fds      , Gs^Fds      , Hh^Fds      , Hh^Fds      
Gs^Fds      , Gs^Fds      , Gs          , Gs          , Gs^Efm      , Gs          , Gg          , Gs^Fds      , Ss          , Gs^Fds      , Wwg         , Wog         , Wwg         , Ds          , Ds          , Wwf         , Ds          , Gs^Fds      , Gs          , Gs          , Rb          , Rb          , Gs          , Gs          , Gs          , Ce          , Ce          , Ce          , Gs          , Gs          , Gs^Fds      , Gs          , Rrc         , Gs^Efm      , Gs^Efm      , Gg^Eff      , Gg^Eff      , Gg^Efm      , Gg          , Gg          , Gg^Efm      , Gg^Efm      , Gs^Fds      , Gs^Fds      , Hh^Fds      , Hh^Fds      
Gs          , Gs          , Gs^Efm      , Gs          , Gs          , Gs^Fds      , Gs^Fds      , Gg          , Wwg         , Wwg         , Wwg         , Wwg         , Ds          , Ds          , Ds          , Wwf         , Ds          , Gs^Fds      , Rb          , Rb          , Gs^Vht      , Gs          , Gs          , Gs          , Gs          , Gs          , Gs          , Gs          , Gs          , Gs          , Gs          , Gs          , Rrc         , Gs^Efm      , Gs          , Gs^Efm      , Gs^Efm      , Gg^Eff      , Gg^Eff      , Gs^Fds      , Gs^Fds      , Hh^Vhh      , Gs^Fds      , Gs^Fds      , Hh^Fds      , Gs^Fds      
Gs          , Gs          , Gs          , Gs          , Gs^Fds      , Gs^Fds      , Wwg         , Wwg^Bw|     , Wwg         , Wwg         , Wwf         , Ds          , Ds          , Dd^Vdt      , Wwf         , Wwf         , Ds          , Rb          , Gs          , Gs          , Gs          , Gs          , Gs^Efm      , Gs          , Gs^Efm      , Gs          , Gs          , Gs          , Gs^Efm      , Gs          , Gs          , Gs          , Rrc         , Gs          , Gs          , Gs^Efm      , Gs          , Gs^Efm      , Gs^Fds      , Gs^Fds      , Gs^Fds      , Gs^Fds      , Gs^Fds      , Gs^Fds      , Hh^Fds      , Hh^Fds      
Gs^Fds      , Gs^Fds      , Gs^Fds      , Gs^Fds      , Wwg         , Wwg         , Wwg         , Wwg^Bw|     , Ch          , Ch          , Ch          , Wwf         , Wwf         , Wwf         , Ds          , Ds          , Rb          , Rb          , Gs          , Gs          , Gs^Fds      , Gs          , Gs          , Gs          , Gs          , Gs          , Gs          , Gs          , Gs          , Gs          , Gs          , Gs          , Rrc         , Gs          , Gs^Vh       , Gs          , Gs          , Gs          , Gs^Fds      , Gs^Fds      , Gs^Fds      , Gs^Fds      , Gs^Fds      , Hh^Fds      , Hh^Fds      , Hh^Fds      
Gs^Fds      , Gs^Fds      , Wwg         , Wwg         , Wwg         , Wwg         , Gg          , 1 Kh        , Ch          , Ch          , Gg          , Ds          , Wwf         , Ds          , Rb          , Rb          , Gs          , Gs          , Gs^Fds      , Gs^Fds      , Hh^Fds      , Gs^Fds      , Hh          , Gs^Fds      , Hh          , Gs          , Gs^Fds      , Gs          , Gs          , Gs          , Gs^Fds      , Gs          , Rrc         , Gs          , Gs          , Gs          , Gs^Fds      , Gs^Fds      , Gs^Fds      , Gs^Fds      , Gs^Fds      , Gs^Fds      , Hh^Fds      , Hh^Fds      , Hh^Fds      , Hh^Fds      
Wwg         , Wwg         , Wwg         , Wwg         , Gg          , Gg          , Gg          , Gg          , Gs          , Gs          , Gs          , Gg          , Wwf^Bw/     , Rb          , Gs          , Gs          , Gs^Fds      , Gs^Fds      , Hh^Fds      , Hh^Fds      , Hh^Fds      , Hh^Fds      , Hh^Fds      , Hh^Fds      , Hh^Fds      , Hh          , Hh^Fds      , Gs^Fds      , Hh          , Gs^Fds      , Gs^Fds      , Gs          , Rrc         , Gs          , Gs^Fds      , Gs          , Gs^Fds      , Gs^Fds      , Gs^Fds      , Gs^Fds      , Hh^Fds      , Hh^Fds      , Hh^Fds      , Hh^Fds      , Hh^Fds      , Hh^Fds      
Wwg         , Wwg         , Gg          , Gg          , Gg          , Gg          , Gs          , Gs          , Gs          , Gs          , Rb          , Rb          , Wwf         , Gs          , Gs          , Gs^Fds      , Gs^Fds      , Hh^Fds      , Hh^Fds      , Hh^Fds      , Hh^Fds      , Hh^Fds      , Hh^Fds      , Hh^Fds      , Hh^Fds      , Hh^Fds      , Hh^Fds      , Hh^Fds      , Hh          , Gs^Fds      , Gs^Fds      , Gs^Fds      , Rrc         , Gs^Fds      , Gs^Fds      , Gs^Fds      , Gs^Fds      , Gs^Fds      , Gs^Fds      , Gs^Fds      , Gs^Fds      , Hh^Fds      , Hh^Fds      , Hh^Fds      , Hh^Fds      , Hh^Fds      
