border_size=1
usage=map

Gs^Fds      , Gg          , Gs^Fds      , Gs^Fds      , Gs^Fds      , Gs^Fds      , Gs^Fds      , Gs^Fds      , Gs^Fds      , Gs^Fds      , Gs^Fds      , Gs^Fds      , Gs^Fds      , Gs^Fds      , Re          , Gg          , Ch          , Rr          , Re^Br|      , Rr          , Ch          , Gg          , Wwf         , Wwf         , Gg          , Gg          , Rb^Gvs      , Gg          , Gs^Fds      , Gs^Fds      , Gs^Fds      , Gs^Fds      , Gs^Fds      , Gs^Fds      , Gs^Fds      , Gs^Fds      , Gs^Fds      , Gs^Fds      , Gs^Fds      , Gs^Fds      , Gs^Fds      , Gs^Fds      , Ww          , Ww          , Ww          , Ww          
Gs^Fds      , Gs^Fds      , Gs^Fds      , Gs^Fds      , Gs^Fds      , Gs^Fds      , Gs^Fds      , Gs^Fds      , Gs^Fds      , Gs^Fds      , Re          , Gs^Fds      , Re          , Re          , Gs^Fds      , Gg          , Ch          , Rr^Vhc      , Re^Br|      , Rr          , Ch          , Gg          , Wwf         , Wwf         , Gs^Vh       , Gg          , Rb^Gvs      , Rb^Gvs      , Rb^Gvs      , Gs^Fds      , Gs^Fds      , Gs^Fds      , Gs^Fds      , Gs^Fds      , Gs^Fds      , Gs^Fds      , Gg^Ve       , Gs^Fds      , Gs^Fds      , Gs^Fds      , Gs^Fds      , Gs^Fds      , Ww          , Ww          , Wo          , Wo          
Gs^Fds      , Gs^Fds      , Gs^Fds      , Gs^Fds      , Gs^Fds      , Gs^Fds      , Gs^Fds      , Gs^Fds      , Re          , Re          , Gg^Ve       , Re          , Gs^Fds      , Gs^Fds      , Gs^Fds      , Gg          , Ch          , Rr          , Re^Br|      , Rr^Vhc      , Ch          , Kh          , Wwf^Bsb\    , Wwf         , Gg          , Gg          , Rb^Gvs      , Rb^Gvs      , Rb^Gvs      , Rb^Gvs      , Rb^Gvs      , Gs^Fds      , Gg          , Gg          , Gg          , Gg          , Gg          , Gs^Fds      , Gs^Fds      , Gs^Fds      , Ww          , Ww          , Ww          , Wo          , Wo          , Wo          
Gs^Fds      , Gs^Fds      , Gs^Fds      , Gs^Fds      , Gs^Fds      , Gs^Fds      , Re          , Re          , Gs^Fds      , Gs^Fds      , Gs^Fds      , Gs^Fds      , Hh          , Hh          , Hh          , Gg          , Gg          , Ch          , Re^Br/      , Ch          , Gg          , Gg          , Wwf         , Wwf^Bsb\    , Rr          , Rb^Gvs      , Rb^Gvs      , Rb^Gvs      , Rb^Gvs      , Rb^Gvs      , Rb^Gvs      , Rb^Wm       , Gg          , Gg          , Gg          , Gg          , Gg          , Gg          , Gg          , Gg          , Ww          , Ww          , Ww          , Wo          , Wo          , Wo          
Gs^Fds      , Gs^Fds      , Gs^Fds      , Gs^Fds      , Re          , Re          , Gs^Fds      , Gs^Fds      , Hh          , Hh          , Hh          , Hh          , Hh          , Hh          , Gg          , Gg          , Re^Br/      , Re^Br/      , Gg          , Gg          , Rb^Gvs      , Gg          , Wwg         , Wwg         , Gg          , Rr          , Rr          , Rb^Gvs      , Rb^Gvs      , Rb^Gvs      , Gg          , Gg          , Gg          , Gg          , Rr          , Gg          , Ch          , Ch          , Ch          , Ww          , Ww          , Ww          , Ww          , Wo          , Wo          , Wo          
Hh          , Gs^Fds      , Gs^Fds      , Re          , Gs^Fds      , Gs^Fds      , Hh          , Hh          , Md          , Md          , Md          , Hh          , Hh          , Gg          , Gg          , Re^Br/      , Gg          , Gg          , Rb^Gvs      , Rb^Gvs      , Rb^Gvs      , Rb^Gvs      , Wwg         , Wwg         , Gg          , Gg          , Rr          , Rr          , Rr          , Rr^Vd       , Rr          , Gg          , Rr          , Rr          , Ch          , 1 Kh        , Rr^Vhc      , Rr^Vhc      , Rr^Vhc      , Ww          , Ww          , Ww          , Wo          , Wo          , Wo          , Wo          
Hh          , Hh          , Gs^Fds      , Re          , Gs^Fds      , Hh          , Hh          , Md          , Md          , Md          , Hh          , Hh          , Gs          , Gg          , Gg          , Re^Br|      , Gg          , Rb^Gvs      , Rb^Gvs      , Rb^Gvs      , Wwg         , Wwg         , Wwg         , Wwg         , Rr          , Rr          , Gs^Fds      , Gs^Fds      , Gs^Fds      , Rr          , Gs^Fds      , Rr          , Gs^Fds      , Ch          , Ch          , Rr^Vhc      , Ww          , Ww          , Ww          , Ww          , Ww          , Ww          , Wo          , Wo          , Wo          , Wo          
Mm          , Hh          , Hh          , Re          , Hh          , Hh          , Md          , Md          , Md          , Hh          , Hh          , Gs          , Ce          , Gg          , Gg          , Re^Br|      , Gg          , Rb^Gvs      , Wwg         , Wwg         , Wwg         , Wwg         , Rr^Vhc      , Rr          , Kh          , Gs^Fds      , Ww          , Gs^Fds      , Ww          , Gs^Fds      , Ww          , Gs^Fds      , Ww          , Ww          , Ww          , Ww          , Ww          , Ww          , Ww          , Ww          , Ww          , Mm          , Wo          , Wo          , Wo          , Wo          
Mm          , Mm          , Mm          , Re          , Md          , Md          , Mm^Xm       , Mm^Xm       , Mm          , Hh          , Hh^Vhh      , Dd          , Rd          , Ke          , Re^Br/      , Re^Br|      , Gs          , Rb^Gvs      , Wwg         , Wwg         , Wwg         , Wwg         , Ch          , Ch          , Ww          , Ww          , Ww          , Ww          , Ww          , Ww          , Ww          , Ww          , Ww          , Ww          , Wo          , Ww          , Wwr         , Wwr         , Ww          , Ww          , Mm          , Mm^Vhh      , Wo          , Wo          , Wo          , Wo          
Mm^Xm       , Mm          , Mm^Xm       , Co          , Mm^Xm       , Mm^Xm       , Md          , Md          , Hh          , Hh          , Rd          , Rd          , Re^Br/      , Re^Br/      , Dd          , Gs          , Gs          , Gs          , Wwg         , Wwg         , Ww          , Ww          , Ww          , Ww          , Ww          , Ww          , Wwr         , Wwr         , Ww          , Ww          , Wo          , Ww          , Wwr         , Ww          , Ww          , Ww          , Ww          , Ww          , Ww          , Ww          , Wo          , Wo          , Wo          , Wo          , Wo          , Wo          
Mm^Xm       , Mm^Xm       , Mm          , Ko          , Co          , Mm          , Hh          , Hh          , Rd          , Rd          , Re^Br/      , Re^Br/      , Dd          , Dd          , Hhd         , Dd          , Dd          , Ww          , Ww          , Ww          , Ww          , Ww          , Ww          , Ww          , Ww          , Wwr         , Ww          , Ww          , Ww          , Wo          , Ww          , Ww          , Ww          , Ww          , Ww          , Wwr         , Wwr         , Ww          , Ww          , Wo          , Wo          , Wo          , Wo          , Wo          , Wo          , Wo          
Mm          , Mm^Xm       , Mm          , Mm          , Hh          , Re          , Rd          , Rd          , Re^Br/      , Re^Br/      , Dd          , Dd          , Hhd         , Hhd         , Mm          , Hhd         , Hhd         , Ww          , Ww          , Wwr         , Wwr         , Ww          , Ww          , Ww          , Wwr         , Wwr         , Ww          , Ww          , Ww          , Ww          , Ww          , Ww          , Ww          , Ww          , Ww          , Wwr         , Ww          , Ww          , Wo          , Wo          , Wo          , Wo          , Wo          , Wo          , Wo          , Wo          
Mm          , Mm          , Mm          , Mm          , Hh          , Re          , Rd          , Rd          , Re^Br|      , Dd          , Hhd         , Hhd         , Hhd         , Mm          , Mm          , Mm^Vhh      , Hhd         , Ww          , Ww          , Wwr         , Wwr         , Hh          , Ww          , Ww          , Wwr         , Ww          , Ww          , Ww          , Gs^Fds      , Gs^Fds      , Rb          , Ss          , Ss          , Ww          , Ds          , Ww          , Ww          , Ww          , Ww          , Wo          , Wo          , Wo          , Wo          , Wo          , Wo          , Wo          
Hh          , Hh          , Hh          , Hh          , Dd^Vda      , Dd          , Dd^Do       , Rd          , Re^Br|      , Dd          , Hhd         , Hhd         , Cd          , Rd          , Rd          , Hhd         , Cud         , Ww          , Ww          , Wwr         , Wwr         , Hh          , Wo          , Wo          , Wo          , Ww          , Wwr         , Ket         , Gs^Fds      , Gs^Fds      , Rb          , Ss^Vhs      , Hh^Fds      , Mm          , Dd          , Ds^Vct      , Wwf         , Ww          , Ww          , Wo          , Wo          , Wo          , Wo          , Wo          , Wo          , Wo          
Hh          , Hh          , Dd          , Dd          , Dd          , Dd          , Rd          , Rd          , Re^Br|      , Dd          , Cd          , Cd          , Wwg         , Wwg         , Wwg         , Cud         , Cud         , Ww          , Ww          , Ww          , Ww          , Wo          , Wo          , Wo          , Wo          , Ww          , Wwr         , Gs^Fds      , Gs^Fds      , Rb          , Hh^Fds      , Hh^Fds      , Mv          , Mm          , Dd          , Ds          , Wwf         , Wwr         , Ww          , Ww          , Wo          , Wo          , Wo          , Wo          , Wo          , Wo          
Dd          , Dd          , Dd          , Dd          , Dd          , Rd          , Rd          , Rd          , Rd          , Re^Br\      , Kd          , Wwg         , Wog         , Wog         , Wwg         , Wwg         , Wwg         , Ww          , Ww          , Ww          , Wo          , Wo          , Wo          , Wo          , Wo          , Ww          , Ss          , Gs^Fds      , Hh^Fds      , Rb          , Hh^Fds      , Mm          , Mm          , Mm          , Co          , Wwf         , Ds          , Ds          , Ww          , Ww          , Wo          , Wo          , Wo          , Wo          , Wo          , Wo          
Dd          , Dd          , Dd          , Dd          , Gs^Ft       , Gs^Ft       , Gs^Ft       , Rd          , Rd          , Dd^Do       , Kd          , Wwg         , Wog         , Wog         , Wwg         , Wwg         , Wwg         , Ww          , Ww          , Ww          , Wo          , Wo          , Wo          , Wo          , Ww          , Ww          , Gs^Fds      , Ss          , Ss^Vhs      , Rb          , Rb          , Rb          , Mm          , Ko          , Dd          , Wwf         , Wwf         , Wwr         , Ww          , Ww          , Wo          , Wo          , Wo          , Wo          , Wo          , Wo          
Dd          , Dd          , Dd          , Gs^Ft       , Wwg         , Gs          , Gs          , Rd          , Re^Br/      , Re^Br/      , Cd          , Wwg         , Wwg         , Wog         , Wwg         , Wwg         , Cud         , Ww          , Ww          , Ww          , Ww          , Wo          , Wwr         , Wo          , Ww          , Ww          , Ww          , Ss          , Ss          , Gs^Fds      , Hh^Fds      , Hh^Fds      , Hh^Fds      , Mm          , Ds          , Ds^Vct      , Ww          , Ww          , Ww          , Ww          , Wo          , Wo          , Wo          , Wo          , Wo          , Wo          
Dd          , Dd          , Dd          , Gs^Ft       , Gs^Ft       , Gs          , Gs^Ft       , Rd          , Re^Br|      , Dd          , Hhd         , Cd          , Cd          , Wwg         , Rd          , Cud         , Cud         , Ww          , Ww          , Ww          , Ww          , Ww          , Wwr         , Hh          , Ww          , Ww          , Ww          , Ww          , Ww          , Gs^Fds      , Gs^Fds      , Gs^Fds      , Ww          , Mm          , Ww          , Ww          , Wwr         , Ww          , Ww          , Wo          , Wo          , Wo          , Wo          , Wo          , Wo          , Wo          
Hh          , Dd          , Dd          , Dd          , Dd          , Gs^Ft       , Rd          , Rd          , Re^Br|      , Dd          , Dd          , Hhd         , Hhd         , Rd          , Mm          , Hhd         , Hhd         , Ww          , Ww          , Wwr         , Wwr         , Wwr         , Hh          , Hh          , Ww          , Ww          , Wo          , Ww          , Ww          , Ww          , Ww          , Ww          , Ww          , Ww          , Ww          , Ww          , Wwr         , Wwr         , Ww          , Wo          , Wo          , Wo          , Wo          , Wo          , Wo          , Wo          
Hh          , Hh          , Hh          , Dd          , Dd^Vda      , Rd          , Rd          , Rd          , Rd          , Re^Br\      , Re^Br\      , Dd          , Hhd         , Mm          , Mm          , Mm^Vo       , Hhd         , Wwf         , Ww          , Ww          , Ww          , Ww          , Ww          , Ww          , Ww          , Ww          , Ww          , Ww          , Wwr         , Ww          , Ww          , Ww          , Wo          , Ww          , Ww          , Ww          , Ww          , Ww          , Ww          , Wo          , Wo          , Wo          , Wo          , Wo          , Wo          , Wo          
Mm          , Mm          , Hh          , Dd          , Rd          , Rd          , Rd          , Rd          , Dd^Do       , Rd          , Rd          , Re^Br\      , Re^Br\      , Hhd         , Hhd         , Hhd         , Hhd         , Hhd         , Wwg         , Ww          , Ww          , Ww          , Ww          , Ww          , Gs^Fds      , Ww          , Ww          , Ww          , Ww          , Ww          , Ww          , Ww          , Ww          , Ww          , Ww          , Ww          , Ww          , Ww          , Ww          , Mm          , Mm^Vhh      , Wo          , Wo          , Wo          , Wo          , Wo          
Mm          , Mm          , Mm          , Hh          , Re          , Rd          , Hh          , Dd          , Dd          , Dd          , Dd          , Rd          , Rd          , Re^Br\      , Re^Br\      , Dd          , Dd          , Gs          , Wwg         , Wwg         , Ch          , Ww          , Ch          , Gs^Fds      , Gs^Fds      , Gs^Fds      , Gs^Fds      , Ww          , Gg          , Ww          , Gg          , Ww          , Ch          , Ww          , Rr^Vhc      , Wwg         , Ww          , Ww          , Ww          , Ww          , Mm          , Wog         , Wo          , Wo          , Wo          , Wo          
Mm          , Mm          , Mm^Xm       , Mm          , Co          , Hh          , Hh          , Dd          , Hh          , Dd          , Hh          , Dd          , Dd          , Rd          , Rd          , Re^Br\      , Gs          , Gs          , Wwg         , Wwg         , Wwg         , Kh          , Rr^Vhc      , Gs^Fds      , Gs^Fds      , Gs^Fds      , Gs^Fds      , Gg          , Gg^Eff      , Gg^Eff      , Gg^Eff      , Gg          , Gg          , Ch          , Rr^Vhc      , Rr^Vhc      , Ww          , Ww          , Ww          , Ww          , Ww          , Wo          , Wo          , Wo          , Wo          , Wo          
Mm^Xm       , Mm^Xm       , Mm^Xm       , Mm^Xm       , Ko          , Md          , Md          , Hh          , Md          , Hh          , Hh          , Hh^Vhh      , Dd          , Dd          , Gs          , Re^Br|      , Gs          , Gs          , Gg^Eff      , Wwg         , Wwg         , Wwg         , Wwg         , Rr          , Rr          , Gs^Fds      , Gg^Eff      , Gg^Eff      , Gg          , Gg          , Gg^Eff      , Gg^Eff      , Rr          , Ch          , Ch          , Rr^Vhc      , Ch          , Ww          , Ww          , Ww          , Ww          , Wo          , Wo          , Wo          , Wo          , Wo          
Mm          , Mm^Xm       , Mm          , Co          , Mm          , Mm^Xm       , Md          , Md          , Md          , Md          , Hh          , Hh          , Hh          , Gs          , Gs          , Re^Br|      , Gg          , Gg^Eff      , Gg^Eff      , Gg^Eff      , Gg^Eff      , Wwg         , Wwg         , Gg          , Gg          , Rr          , Rr          , Gg^Eff      , Gg^Eff      , Gg^Eff      , Rr          , Rr          , Gg^Eff      , 2 Kh        , Gg          , Ch          , Gs^Fds      , Gs^Fds      , Gs^Fds      , Ww          , Ww          , Wo          , Wo          , Wo          , Wo          , Wo          
Mm          , Mm          , Hh          , Re          , Hh          , Md          , Hh          , Md          , Hh          , Hh          , Gs^Fds      , Hh          , Hh          , Gs          , Gg          , Re^Br|      , Gg^Eff      , Gg^Eff      , Gg          , Gg^Eff      , Gg^Eff      , Wwg         , Wwg         , Gg          , Gg          , Gg          , Rr          , Rr^Vd       , Rr          , Rr          , Gg^Eff      , Gg^Eff      , Gg^Eff      , Gg          , Gg^Eff      , Gg^Eff      , Gs^Fds      , Gs^Fds      , Gs^Fds      , Ww          , Ww          , Wo          , Wo          , Wo          , Wo          , Wo          
Hh          , Hh          , Gs^Fds      , Re          , Gs^Fds      , Hh          , Gs^Fds      , Hh          , Gs^Fds      , Gs^Fds      , Gs^Fds      , Gs^Fds      , Gs^Fds      , Gs^Fds      , Ch          , Re^Br|      , Ch          , Gg^Eff      , Gg^Eff      , Gg^Eff      , Gg          , Wwg         , Wwf         , Gg          , Rr          , Rr          , Gg          , Gg          , Gs^Fds      , Gs^Fds      , Gs^Fds      , Gg          , Gg^Eff      , Gg^Eff      , Gg          , Gg^Eff      , Gs^Fds      , Gs^Fds      , Gs^Fds      , Ww          , Ww          , Ww          , Ww          , Wo          , Wo          , Wo          
Gg          , Gs^Fds      , Gs^Fds      , Re          , Re          , Gs^Fds      , Gg^Ve       , Gs^Fds      , Re          , Gs^Fds      , Re          , Gs^Fds      , Gs^Fds      , Ch          , Rr          , Re^Br|      , Rr^Vhc      , Ch          , Kh          , Gg          , Gg          , Wwf         , Wwf         , Gg          , Rr          , Gg          , Gs^Fds      , Gs^Fds      , Gs^Fds      , Gs^Fds      , Gs^Fds      , Gs^Fds      , Gs^Fds      , Gg          , Gg^Ve       , Gg          , Gs^Fds      , Gs^Fds      , Gs^Fds      , Ww          , Ww          , Ww          , Ww          , Ww          , Wo          , Wo          
Gs^Fds      , Gs^Fds      , Gs^Fds      , Gs^Fds      , Gs^Fds      , Re          , Re          , Re          , Gs^Fds      , Re          , Gs^Fds      , Re          , Re          , Ch          , Rr^Vhc      , Re^Br|      , Rr          , Ch          , Gg          , Gg          , Gg          , Wwf         , Wwf         , Gs^Vh       , Rr          , Gs^Fds      , Gs^Fds      , Gs^Fds      , Gs^Fds      , Gs^Fds      , Gs^Fds      , Gs^Fds      , Gs^Fds      , Gs^Fds      , Gs^Fds      , Gs^Fds      , Gs^Fds      , Gs^Fds      , Gs^Fds      , Gs^Fds      , Gs^Fds      , Ww          , Ww          , Ww          , Wo          , Wo          
Gs^Fds      , Gs^Fds      , Gg          , Gs^Fds      , Gs^Fds      , Gs^Fds      , Gs^Fds      , Gs^Fds      , Gs^Fds      , Gs^Fds      , Gs^Fds      , Gs^Fds      , Re          , Ch          , Rr          , Re^Br|      , Rr          , Ch          , Gg          , Gg          , Gg          , Wwg         , Wwg         , Gg          , Rr          , Gs^Fds      , Gs^Fds      , Gs^Fds      , Gs^Fds      , Gs^Fds      , Gs^Fds      , Gs^Fds      , Gs^Fds      , Gs^Fds      , Gs^Fds      , Gs^Fds      , Gs^Fds      , Gs^Fds      , Gs^Fds      , Gs^Fds      , Gs^Fds      , Ww          , Ww          , Ww          , Ww          , Wo          
