border_size=1
usage=map

Wo          , Wo          , Wo          , Wo          , Wo          , Wo          , Wo          , Wo          , Wo          , Wo          , Wo          , Wo          , Wo          , Wo          , Wo          , Wo          , Wo          , Wo          , Wo          , Wo          , Wo          , Wo          , Wo          , Wo          , Wo          , Wo          , Wo          , Wo          , Wo          , Wo          , Wo          , Wo          , Wo          , Wo          , Wo          , Wo          , Wo          , Wo          , Wo          , Wo          , Wo          , Wo          , Wo          , Wo          , Wo          , Wo          
Wo          , Wo          , Wo          , Wo          , Wo          , Wo          , Wo          , Wo          , Wo          , Wo          , Wo          , Wo          , Wo          , Wo          , Wo          , Wo          , Wo          , Wo          , Wo          , Wo          , Wo          , Wo          , Wo          , Wo          , Wo          , Wo          , Wo          , Wo          , Wo          , Wo          , Wo          , Wo          , Wo          , Wo          , Wo          , Wo          , Wo          , Wo          , Wo          , Wo          , Wo          , Wo          , Wo          , Wo          , Wo          , Wo          
Wo          , Wo          , Wo          , Wo          , Wo          , Wo          , Wo          , Wo          , Wo          , Wo          , Wo          , Wo          , Wo          , Wo          , Wo          , Wo          , Wo          , Wo          , Wo          , Wo          , Wo          , Wo          , Wo          , Wo          , Wo          , Wo          , Wo          , Wo          , Wo          , Wo          , Wo          , Wo          , Wo          , Wo          , Wo          , Wo          , Wo          , Wo          , Wo          , Wo          , Wo          , Wo          , Wo          , Wo          , Wo          , Wo          
Wo          , Wo          , Wo          , Wo          , Wo          , Wo          , Wo          , Wo          , Wo          , Wo          , Wo          , Wo          , Wo          , Wo          , Wo          , Wo          , Wo          , Wo          , Wo          , Wo          , Wo          , Wo          , Wo          , Wo          , Wo          , Wo          , Wo          , Wo          , Wo          , Wo          , Wo          , Wo          , Wo          , Wo          , Wo          , Wo          , Wo          , Wo          , Wo          , Wo          , Wo          , Wo          , Wo          , Wo          , Wo          , Wo          
Wo          , Wo          , Wo          , Wo          , Wo          , Wo          , Wo          , Wo          , Wo          , Wo          , Wo          , Wo          , Wo          , Wo          , Wo          , Wo          , Ww          , Wwr         , Wwr         , Wo          , Wo          , Wo          , Wo          , Wo          , Wo          , Wo          , Wo          , Wo          , Wo          , Wo          , Wo          , Wo          , Wo          , Wo          , Wo          , Wo          , Wo          , Wo          , Wo          , Wo          , Wo          , Wo          , Wo          , Wo          , Wo          , Wo          
Wo          , Wo          , Wo          , Wo          , Wo          , Wo          , Wo          , Wo          , Wo          , Wo          , Wo          , Wo          , Wo          , Wo          , Ww          , Ww          , Ww          , Ww          , Ww          , Wo          , Wo          , Wo          , Wo          , Wo          , Wo          , Wo          , Wo          , Wo          , Wo          , Wo          , Wo          , Wo          , Wwr         , Wo          , Ww          , Wo          , Ww          , Wo          , Ww          , Wo          , Wo          , Wo          , Wo          , Wo          , Wo          , Wo          
Wo          , Wo          , Wo          , Wo          , Wo          , Wo          , Wo          , Wo          , Wo          , Wo          , Wwr         , Wwr         , Wwr         , Ww          , Ww          , Ww          , Hh          , Ww          , Ww          , Ww          , Ww          , Wo          , Wo          , Wwr         , Wwr         , Wo          , Wo          , Wo          , Wo          , Wo          , Ww          , Wwr         , Ww          , Ww          , Ww          , Ww          , Ww          , Ww          , Ww          , Ww          , Ww          , Wo          , Wo          , Wo          , Wo          , Wo          
Wo          , Wo          , Wo          , Wo          , Wo          , Wo          , Wo          , Wo          , Ww          , Wwr         , Ww          , Wwr         , Wwr         , Ww          , Ss          , Hh          , Hh          , Hh          , Hh          , Ww          , Ww          , Ww          , Ww          , Wo          , Wo          , Wo          , Wwr         , Wo          , Ww          , Wwr         , Ww          , Ww          , Ww          , Ww          , Ww          , Ww          , Ww          , Ww          , Hh          , Ww          , Ww          , Ww          , Ww          , Wo          , Wo          , Wo          
Wo          , Wo          , Wo          , Wo          , Wo          , Wo          , Ww          , Ww          , Ww          , Ww          , Ww          , Ww          , Ss          , Ss          , Gs^Fds      , Gs^Fds      , Gg          , Rr^Vhc      , Rr          , Hh          , Hh          , Ww          , Ww          , Ww          , Ww          , Wwr         , Wwr         , Ww          , Ww          , Ww          , Ww          , Ww          , Ch          , Ww          , Ch          , 1 Kh        , Ch          , Ds          , Hh          , Ds          , Ds          , Ww          , Ww          , Ww          , Wo          , Wo          
Wo          , Wo          , Wo          , Wo          , Wo          , Ww          , Ww          , Ww          , Ww          , Ww          , Hh          , Hh          , Gs^Fds      , Ss^Vhs      , Gg          , Gg          , Gg          , Rr          , Rr^Br/      , Ch          , Ch          , Kh          , Ww          , Ww          , Ww          , Ww          , Ww          , Ww          , Ww          , Ww          , Gs^Fds      , Gs^Fds      , Rr          , Ch          , Rr^Vhc      , Ch          , Rr^Vhc      , Rr^Vhc      , Gs^Eff      , Hh          , Hh          , Ds          , Ww          , Ww          , Wo          , Wo          
Wo          , Wo          , Wo          , Wo          , Wo          , Ww          , Ww          , Ww          , Hh          , Hh          , Gs^Fds      , Gs^Fds      , Gg          , Gg          , Rb^Br/      , Rb^Br/      , Rb^Br\      , Rb^Br/      , Rr          , Rr          , Rr          , Ch          , Ww          , Ww          , Ww          , Ww^Vm       , Ww          , Ww          , Gs^Fds      , Gs^Fds      , Gs^Fds      , Gs^Fds      , Rb^Br/      , Rb^Br/      , Rr          , Rr          , Gs^Eff      , Gs^Eff      , Gs          , Gs^Eff      , Gs^Eff      , Hh          , Ww          , Ww          , Wo          , Wo          
Wo          , Wo          , Wo          , Wo          , Wo          , Ww          , Ww          , Hh          , Hh^Fds      , Hh          , Gs^Fds      , Gg          , Rb^Br/      , Rb^Br/      , Gg          , Gg          , Rr          , Rr          , Gg^Efm      , Gg^Efm      , Gg^Efm      , Rr^Vhc      , Ww          , Ww          , Wwr         , Ww          , Ww          , Ww          , Gs^Fds      , Gs^Fds      , Gg          , Gg          , Rb^Br|      , Gg          , Rr          , Gs^Eff      , Gs          , Gs          , Gs^Eff      , Gs^Eff      , Hh          , Hh          , Ww          , Ww          , Wo          , Wo          
Wo          , Wo          , Wo          , Wo          , Ww          , Ww          , Ww          , Hh          , Hh^Fds      , Hh          , Gs^Fds      , Rb^Br/      , Gg          , Gg          , Rr          , Rr          , Gll^Fp      , Gg^Efm      , Gg^Efm      , Gg^Efm      , Gll^Fp      , Gll^Fp      , Ww          , Ww          , Wo          , Wo          , Ww          , Ww          , Gs^Fds      , Gs^Fds      , Gg          , Gg          , Rb^Br|      , Gg          , Rr          , Gs^Eff      , Gs^Eff      , Gs          , Gs^Eff      , Gs^Eff      , Hh^Fds      , Hh          , Ww          , Ww          , Wo          , Wo          
Wo          , Wo          , Wo          , Wo          , Ww          , Ww          , Hh          , Hh          , Hh^Vhh      , Gs^Fds      , Gg          , Rb^Br|      , Rr          , Rr          , Gll^Fp      , Gll^Fp      , Gll^Fp      , Gll^Fp      , Gll^Fp      , Gll^Fp      , Gll^Fp      , Gll^Fp      , Ww          , Ww          , Ww          , Wwr         , Ww          , Ww          , Gs^Fds      , Gs^Fds      , Gg          , Gg          , Rb^Br|      , Rr          , Gs^Vh       , Gg          , Gg          , Gs^Eff      , Gs^Eff      , Gs^Fds      , Hh^Fds      , Hh          , Wo          , Wo          , Wo          , Wo          
Wo          , Wo          , Wo          , Wo          , Ww          , Ww          , Hh          , Hh^Fds      , Gs^Fds      , Gg          , Gg          , Rb^Br|      , Rr          , Gg^Efm      , Gll^Fp      , Gll^Fp      , Hh          , Hh          , Hh^Fp       , Gll^Fp      , Gll^Fp      , Gll^Fp      , Ww          , Ww          , Wo          , Wo          , Ww          , Ww          , Co          , Gs^Fds      , Gg          , Gg          , Rb^Br|      , Rr          , Gg          , Gg          , Gs          , Gs          , Gs^Eff      , Gs^Eff      , Gs^Eff      , Hh          , Wo          , Wo          , Wo          , Wo          
Wo          , Wo          , Wo          , Wo          , Wo          , Ww          , Hh          , Hh^Fds      , Hh^Fds      , Gg          , Gg          , Rb^Br|      , Rr          , Gs^Vh       , Hh^Fp       , Hh          , Mm          , Mm          , Mm          , Hh^Fp       , Hh          , Hh          , Ww          , Ww          , Wo          , Wwr         , Ww          , Ww          , Ww          , Ds          , Ds          , Gg          , Rb^Br|      , Rr          , Gg          , Gg          , Gs^Eff      , Gs^Eff      , Gs          , Gs          , Gs^Eff      , Gs^Vh       , Wo          , Wo          , Wo          , Wo          
Wo          , Wo          , Wo          , Wo          , Wo          , Ww          , Wo          , Hh          , Hh          , Gs^Fds      , Gg          , Rb^Br|      , Rr          , Gll^Fp      , Gll^Fp      , Hh          , Hh          , Hh          , Hh          , Mm          , Mm          , Hh          , Ww          , Wwr         , Ww          , Wo          , Ww          , Ww          , Ww          , Ww          , Ww          , Ds          , Ch          , Rr^Br\      , Rb^Br\      , Gg          , Gg          , Gs^Eff      , Gs^Eff      , Gs^Eff      , Gs          , Gs^Vh       , Wo          , Wo          , Wo          , Wo          
Wo          , Wo          , Wo          , Wo          , Wo          , Wo          , Wo          , Wo          , Hh          , Hh          , Gg          , Rb^Br|      , Rb^Br\      , Rr          , Rr          , Gll^Fp      , Gll^Fp      , Ch          , Ww          , Ww          , Ww          , Mm          , Ww          , Ww          , Ww          , Ww          , Wwr         , Ww          , Mm          , Ww          , Ww^Vm       , Ww^Bw/      , Kh          , Rr          , Rr          , Rb^Br\      , Rb^Br\      , Gg          , Gs          , Gs          , Hh          , Hh          , Wo          , Wo          , Wo          , Wo          
Wo          , Wo          , Wo          , Wo          , Wo          , Wo          , Wo          , Wo          , Gs^Vh       , Hh          , Re^Gvs      , Gg          , Gg          , Rb^Br\      , Rb^Br\      , Rr          , Rr          , Kh          , Ww^Bw/      , Ww^Vm       , Ww          , Mm          , Ww          , Ww          , Wo          , Wo          , Ww          , Ww          , Mm          , Ww          , Ww          , Ww          , Ch          , Gll^Fp      , Gll^Fp      , Rr          , Rr          , Rb^Br\      , Rb^Br\      , Gs          , Hh          , Hh          , Ww          , Ww          , Ww          , Wo          
Wo          , Wo          , Wo          , Wo          , Wo          , Wo          , Wo          , Wo          , Gs^Vh       , Re^Gvs      , Re^Gvs      , Re^Gvs      , Re^Gvs      , Gg          , Gg          , Rb^Br\      , Rr^Br\      , Ch          , Ds          , Ww          , Ww          , Ww          , Ww          , Ww          , Ww          , Wo          , Wwr         , Ww          , Hh          , Mm          , Mm          , Hh          , Hh          , Hh          , Hh          , Gll^Fp      , Gll^Fp      , Rr          , Rb^Br|      , Gs          , Gs^Fds      , Hh          , Ww          , Ww          , Ww          , Wo          
Wo          , Wo          , Wo          , Wo          , Wo          , Wo          , Wo          , Wo          , Hh          , Re^Gvs      , Re^Gvs      , Re^Gvs      , Re^Gvs      , Re^Gvs      , Re^Gvs      , Gg^Wm       , Rr          , Rb^Br|      , Gg          , Ds          , Ds          , Ww          , Ww          , Wwr         , Wwr         , Wo          , Ww          , Ww          , Gll^Fp      , Hh^Fp       , Hh^Fp       , Mm          , Mm          , Mm          , Hh          , Hh^Fp       , Gs^Vh       , Rr          , Rb^Br|      , Gs          , Gs^Fds      , Hh^Fds      , Hh          , Ww          , Ww          , Wo          
Wo          , Wo          , Wo          , Wo          , Wo          , Wo          , Ww          , Ww          , Hh          , Hh          , Gs^Fds      , Re^Gvs      , Re^Gvs      , Re^Gvs      , Re^Gvs      , Re^Gvs      , Rr          , Rb^Br|      , Gg          , Gg          , Gs^Fds      , Co          , Ww          , Ww          , Ww          , Ww          , Ww          , Ww          , Gll^Fp      , Gll^Fp      , Gll^Fp      , Hh^Fp       , Hh          , Hh          , Gll^Fp      , Gll^Fp      , Gg^Efm      , Rr          , Rb^Br|      , Gs          , Gs          , Hh^Vhh      , Hh          , Ww          , Ww          , Wo          
Wo          , Wo          , Wo          , Wo          , Wo          , Wo          , Ww          , Ww          , Ww          , Hh          , Gs^Fds      , Re^Gvs      , Re^Gvs      , Re^Gvs      , Re^Gvs      , Rr          , Gs^Vh       , Rb^Br|      , Gg          , Gg          , Gs^Fds      , Gs^Fds      , Ww          , Ww          , Wo          , Wo          , Ww          , Ww          , Gll^Fp      , Gll^Fp      , Gll^Fp      , Gll^Fp      , Gll^Fp      , Gll^Fp      , Gll^Fp      , Gll^Fp      , Rr          , Rr          , Rb^Br|      , Gs          , Gs          , Hh^Fds      , Hh          , Ww          , Ww          , Wo          
Wo          , Wo          , Wo          , Wo          , Wo          , Wo          , Wo          , Ww          , Ww          , Hh          , Gs^Fds      , Re^Gvs      , Re^Gvs      , Re^Gvs      , Re^Gvs      , Rr          , Gg          , Rb^Br|      , Gg          , Gg          , Gs^Fds      , Gs^Fds      , Ww          , Ww          , Wo          , Wo          , Ww          , Ww          , Rr^Vhc      , Gg^Efm      , Gg^Efm      , Gll^Fp      , Gg^Efm      , Gll^Fp      , Rr          , Rr          , Rb^Br/      , Rb^Br/      , Gs          , Gs          , Gs          , Hh^Fds      , Hh          , Ww          , Ww          , Wo          
Wo          , Wo          , Wo          , Wo          , Wo          , Wo          , Wo          , Ww          , Ww          , Hh          , Hh          , Gs^Fds      , Re^Gvs      , Re^Gvs      , Re^Gvs      , Rr          , Rb^Br/      , Rb^Br|      , Gg          , Gg          , Gs^Fds      , Gs^Fds      , Ww          , Ww          , Ww          , Wwr         , Ww          , Ww          , Ch          , Rr          , Rr          , Gg^Efm      , Rr          , Rr          , Rb^Br/      , Rb^Br/      , Gg          , Gg          , Gs          , Gs          , Hh          , Hh          , Ww          , Ww          , Ww          , Wo          
Wo          , Wo          , Wo          , Wo          , Wo          , Wo          , Wo          , Ww          , Ww          , Hh          , Ds          , Hh          , Re^Gvs      , Re^Gvs      , Rr^Vhc      , Rr          , Rb^Br|      , Gg          , Gs^Fds      , Gs^Fds      , Gs^Fds      , Gs^Fds      , Ww          , Ww          , Ww          , Ww          , Ww          , Ww          , Kh          , Ch          , Ch          , Rr          , Rr          , Rb^Br|      , Gg          , Gg          , Gg          , Gg          , Ss^Vhs      , Gs^Fds      , Hh          , Hh          , Ww          , Ww          , Ww          , Wo          
Wo          , Wo          , Wo          , Wo          , Wo          , Wo          , Wo          , Ww          , Ww          , Ww          , Ww          , Ds          , Ds          , Ch          , Ch          , Rr          , Ch          , Rr^Vhc      , Rr^Vhc      , Gs^Fds      , Ww          , Ww          , Wwr         , Ww          , Ww          , Ww^Vm       , Ww          , Ww          , Ww          , Hh          , Hh          , Rr          , Rr          , Rb^Br|      , Gg          , Gg          , Gs^Fds      , Gs^Fds      , Ss          , Ss          , Ww          , Ww          , Ww          , Ww          , Wo          , Wo          
Wo          , Wo          , Wo          , Wo          , Wo          , Wo          , Wo          , Wo          , Wo          , Ww          , Ww          , Ww          , Ww          , Mm          , Ww          , Ch          , 2 Kh        , Ch          , Ww          , Ww          , Ww          , Ww          , Wwr         , Wwr         , Wo          , Ww          , Wo          , Ww          , Ww          , Ww          , Ww          , Hh          , Hh          , Rr^Vhc      , Hh          , Gs^Fds      , Hh          , Ss          , Ww          , Wwr         , Wwr         , Ww          , Wwr         , Wo          , Wo          , Wo          
Wo          , Wo          , Wo          , Wo          , Wo          , Wo          , Wo          , Wo          , Wo          , Wo          , Wo          , Ww          , Ww          , Ww          , Ww          , Ww          , Ww          , Ww          , Ww          , Ww          , Ww          , Ww          , Wo          , Wo          , Wo          , Wo          , Wwr         , Wo          , Wo          , Ww          , Ww          , Ww          , Ww          , Hh          , Hh          , Hh          , Ww          , Ww          , Ww          , Wwr         , Wwr         , Wwr         , Wo          , Wo          , Wo          , Wo          
Wo          , Wo          , Wo          , Wo          , Wo          , Wo          , Wo          , Wo          , Wo          , Wo          , Wo          , Wo          , Wo          , Ww          , Wo          , Ww          , Ww          , Ww          , Wwr         , Wwr         , Wo          , Wo          , Wo          , Wo          , Wo          , Wo          , Wo          , Wwr         , Wo          , Wo          , Wo          , Ww          , Ww          , Ww          , Ww          , Ww          , Ww          , Ww          , Ww          , Ww          , Wo          , Wo          , Wo          , Wo          , Wo          , Wo          
Wo          , Wo          , Wo          , Wo          , Wo          , Wo          , Wo          , Wo          , Wo          , Wo          , Wo          , Wo          , Wo          , Wo          , Wo          , Wo          , Wo          , Wwr         , Wo          , Wo          , Wo          , Wo          , Wo          , Wo          , Wo          , Wo          , Wo          , Wo          , Wo          , Wo          , Wo          , Wo          , Wo          , Ww          , Ww          , Ww          , Ww          , Ww          , Wo          , Wo          , Wo          , Wo          , Wo          , Wo          , Wo          , Wo          
Wo          , Wo          , Wo          , Wo          , Wo          , Wo          , Wo          , Wo          , Wo          , Wo          , Wo          , Wo          , Wo          , Wo          , Wo          , Wo          , Wo          , Wo          , Wo          , Wo          , Wo          , Wo          , Wo          , Wo          , Wo          , Wo          , Wo          , Wo          , Wo          , Wo          , Wo          , Wo          , Wo          , Wo          , Wo          , Wo          , Wo          , Wo          , Wo          , Wo          , Wo          , Wo          , Wo          , Wo          , Wo          , Wo          
Wo          , Wo          , Wo          , Wo          , Wo          , Wo          , Wo          , Wo          , Wo          , Wo          , Wo          , Wo          , Wo          , Wo          , Wo          , Wo          , Wo          , Wo          , Wo          , Wo          , Wo          , Wo          , Wo          , Wo          , Wo          , Wo          , Wo          , Wo          , Wo          , Wo          , Wo          , Wo          , Wo          , Wo          , Wo          , Wo          , Wo          , Wo          , Wo          , Wo          , Wo          , Wo          , Wo          , Wo          , Wo          , Wo          
Wo          , Wo          , Wo          , Wo          , Wo          , Wo          , Wo          , Wo          , Wo          , Wo          , Wo          , Wo          , Wo          , Wo          , Wo          , Wo          , Wo          , Wo          , Wo          , Wo          , Wo          , Wo          , Wo          , Wo          , Wo          , Wo          , Wo          , Wo          , Wo          , Wo          , Wo          , Wo          , Wo          , Wo          , Wo          , Wo          , Wo          , Wo          , Wo          , Wo          , Wo          , Wo          , Wo          , Wo          , Wo          , Wo          
Wo          , Wo          , Wo          , Wo          , Wo          , Wo          , Wo          , Wo          , Wo          , Wo          , Wo          , Wo          , Wo          , Wo          , Wo          , Wo          , Wo          , Wo          , Wo          , Wo          , Wo          , Wo          , Wo          , Wo          , Wo          , Wo          , Wo          , Wo          , Wo          , Wo          , Wo          , Wo          , Wo          , Wo          , Wo          , Wo          , Wo          , Wo          , Wo          , Wo          , Wo          , Wo          , Wo          , Wo          , Wo          , Wo          
