border_size=1
usage=map

Md          , Md          , Md          , Md          , Md          , Hhd         , Hhd         , Hhd         , Gd          , Gd          , Gd          , Gd          , Gd          , Rr          , Rr          , Gd          , Gd          , Gd          , Gd          , Gd^Fdf      , Gd^Fdf      , Gd^Fdf      , Gd^Fdf      , Gd^Fdf      , Gd^Fdf      , Gd^Fdf      , Gd^Fdf      , Gd^Fdf      , Gd^Fdf      , Ww          , Ww          , Ww          , Ww          , Ww          , Ww          , Wo          , Wo          , Wo          , Wo          , Wo          , Wo          , Wo          , Wo          , Wo          , Wo          , Wo          
Md          , Ko          , Co          , Co          , Hhd         , Hhd         , Gd          , Gd          , Gd          , Gd^Vh       , Gd          , Gd          , Gd          , Gd          , Gd          , Rr          , Rr          , Gd          , Gd          , Gd^Fdf      , Gd^Fdf      , Gd^Fdf      , Gd^Fdf      , Gd^Fdf      , Gd^Fdf      , Gd^Fdf      , Gd^Fdf      , Gd^Fdf      , Gd^Fdf      , Ww          , Ww          , Ww          , Ww          , Ww          , Ww          , Wo          , Wo          , Wo          , Wo          , Wo          , Wo          , Wo          , Wo          , Wo          , Wo          , Wo          
Md          , Co          , Rr          , Hhd         , Hhd         , Hhd^Wm      , Gd          , Gd          , Gd          , Gd          , Gd          , Gd          , Gd          , Gd          , Gd          , Gd          , Gd          , Rr          , Rr          , Gd          , Gd          , Gd^Fdf      , Gd^Fdf      , Gd^Fdf      , Gd^Fdf      , Gd^Fdf      , Gd^Vh       , Gd^Fdf      , Gd          , Gd          , Gd          , Ce          , Ce          , Ww          , Ww          , Ww          , Ww          , Wo          , Wo          , Wo          , Wo          , Wo          , Wo          , Wo          , Wo          , Wo          
Hhd         , Hhd         , Rr          , Hhd         , Gd          , Gd          , Re          , Re          , Re          , Gd          , Gd          , Gd          , Gd          , Gd          , Gd          , Gd          , Gd          , Ce          , Ke          , Rr          , Gd          , Gd          , Gd          , Gd^Fdf      , Re          , Re          , Re          , Re          , Re          , Gd          , Rr          , Ke          , Gd          , Ww          , Ww          , Ww          , Ww          , Ww          , Ww          , Ww          , Ww          , Wo          , Wo          , Wo          , Wo          , Wo          
Hhd         , Hhd         , Gd          , Rr          , Gd          , Re          , Re          , Re          , Re          , Re          , Ss          , Gd^Fdf      , Gd          , Gd          , Gd          , Gd          , Gd          , Ce          , Ce          , Rr          , Gd          , Gd^Wm       , Re          , Re          , Re          , Re          , Re          , Re          , Rr          , Rr          , Rr          , Gd          , Gd          , Gd          , Gd          , Ww          , Ww          , Ww          , Ww          , Ww          , Ww          , Wo          , Wo          , Wo          , Wo          , Wo          
Gd          , Gd          , Gd          , Rr          , Gd          , Re          , Re          , Re          , Re          , Gd^Fdf      , Hh^Fdf      , Ss          , Ss          , Gd^Vh       , Ss          , Gd          , Gd          , Gd          , Gd          , Rr          , Rr          , Re          , Re          , Re          , Re          , Re          , Rr          , Rr          , Gd          , Gd^Vh       , Rr          , Gd          , Gd          , Gd^Efm      , Gd          , Gd          , Gd^Fdf      , Gd^Fdf      , Gd^Fdf      , Ww          , Ww          , Ww          , Ww          , Wo          , Wo          , Wo          
Gd          , Gd          , Gd          , Rr          , Gd          , Gd          , Gd          , Re          , Gd^Fdf      , Ss          , Ss          , Ss          , Hh^Fdf      , Gd^Fdf      , Ss          , Gd          , Gd          , Gd          , Re          , Re          , Re          , Rr          , Rr          , Re          , Rr          , Rr          , Gd          , Gd          , Gd          , Gd          , Gd          , Rr          , Rr          , Gd          , Gd          , Gd          , Gd^Fdf      , Gd^Fdf      , Gd^Fdf      , Gd^Fdf      , Ww          , Ww          , Ww          , Wo          , Wo          , Wo          
Gd          , Gd          , Gd^Vh       , Rr          , Gd          , Gd          , Gd          , Gd^Fdf      , Gd^Fdf      , Ss          , Ss          , Ss          , Ss          , Ss          , Gd^Fdf      , Ss          , Gd          , Gd          , Re          , Re          , Re          , Re          , Re          , Rr^Vd       , Gd          , Gd          , Gd          , Gd^Efm      , Gd          , Gd          , Hhd         , Gd          , Gd          , Rr          , Gd          , Gd          , Gd^Vh       , Gd^Fdf      , Gd^Fdf      , Gd^Fdf      , Gd^Fdf      , Ww          , Ww          , Ww          , Wo          , Wo          
Gd          , Gd          , Gd          , Rr          , Rr          , Gd          , Gd          , Gd          , Gd          , Gd^Fdf      , Gd^Vh       , Gd^Fdf      , Gd^Fdf      , Ss          , Ss          , Gd^Fdf      , Hhd         , Gd          , Re          , Re          , Re          , Re          , Re          , Rr          , Gd          , Gd^Efm      , Gd          , Gd          , Hhd         , Hhd         , Hhd         , Gd          , Gd          , Rr          , Gd          , Gd          , Gd          , Gd^Fdf      , Gd^Fdf      , Gd^Fdf      , Gd^Fdf      , Ww          , Ww          , Ww          , Wo          , Wo          
Gd          , Gd          , Gd          , Gd          , Gd          , Rr          , Rr          , Gd          , Gd          , Gd          , Ce          , Gd          , Gd          , Gd^Fdf      , Hhd^Fdf     , Hhd^Fdf     , Md          , Hhd         , Hhd         , Re          , Re          , Re          , Re          , Rr          , Gd          , Gd          , Hhd         , Hhd         , Md          , Hhd         , Hhd         , Gd          , Gd          , Rr          , Ce          , Ce          , Ce          , Gd          , Gd^Fdf      , Gd^Fdf      , Gd^Fdf      , Ww          , Ww          , Ww          , Wo          , Wo          
Gd          , Gd          , Gd          , Gd          , Gd          , Gd          , Gd          , Rr          , Rr          , Ce          , Ke          , Ce          , Gd          , Gd^Fdf      , Hhd         , Md          , Mm^Xm       , Md^Vhh      , Md          , Hhd         , Hhd         , Re          , Gd^Vh       , Rr          , Hhd         , Hhd         , Hhd         , Md          , Mm^Xm       , Md          , Hhd         , Gd          , Gd          , Rr          , Rr          , Ke          , Gd^Fdf      , Gd^Fdf      , Gd^Fdf      , Gd^Fdf      , Gd^Fdf      , Ww          , Ww          , Ww          , Wo          , Wo          
Gd^Fdf      , Gd^Fdf      , Gd^Fdf      , Gd          , Gd          , Gd          , Hhd         , Gd          , Gd          , Rr          , Rr          , Gd          , Gd          , Gd          , Hhd         , Md          , Mm^Xm       , Mm^Xm       , Md          , Md          , Md          , Hhd         , Hhd         , Rr          , Ch          , Hhd         , Md          , Md          , Mm^Xm       , Md          , Hhd         , Gd          , Gd^Vh       , Gd          , Rr          , Gd^Fdf      , Gd^Fdf      , Gd^Fdf      , Gd^Fdf      , Gd^Fdf      , Gd^Fdf      , Ww          , Ww          , Ww          , Wo          , Wo          
Gd^Fdf      , Gd^Fdf      , Gd^Fdf      , Gd^Fdf      , Gd^Vh       , Gd          , Hhd         , Hhd         , Hhd         , Hhd         , Hhd         , Rr          , Rr          , Gd          , Hhd         , Md^Vhh      , Md          , Mm^Xm       , Mm^Xm       , Md          , Mm^Xm       , Md          , Ch          , Ch          , Ch          , Ch          , Mm^Xm       , Mm^Xm       , Md          , Md          , Hhd         , Gd          , Gd          , Gd          , Rr          , Gd^Fdf      , Gd^Fdf      , Gd^Fdf      , Gd^Fdf      , Gd^Fdf      , Gd^Fdf      , Ww          , Ww          , Ww          , Wo          , Wo          
Gd^Fdf      , Gd^Fdf      , Gd^Fdf      , Gd^Fdf      , Gd^Fdf      , Gd          , Gd          , Hhd         , Md          , Md          , Md          , Hhd         , Hhd         , Rr          , Rr          , Hhd         , Hhd         , Md          , Md          , Mm^Xm       , Mm^Xm       , Mm^Xm       , Mm^Xm       , 4 Kh        , Mm^Xm       , Mm^Xm       , Mm^Xm       , Ch          , Hhd         , Hhd         , Gd^Fdf      , Gd^Fdf      , Rr          , Rr          , Gd          , Rr          , Rr          , Gd^Fdf      , Gd^Fdf      , Gd^Fdf      , Chr         , Ww          , Ww          , Ww          , Wo          , Wo          
Gd^Fdf      , Gd^Fdf      , Gd^Fdf      , Gd^Fdf      , Gd^Fdf      , Gd          , Gd          , Hhd         , Hhd         , Md          , Hhd         , Hhd         , Rr          , Rr          , Rr^Vd       , Rr          , Rr          , Hhd         , Ch          , Ch          , Mm^Xm       , Mm^Xm       , Mm^Xm       , Mm^Xm       , Mm^Xm       , Mm^Xm       , Mm^Xm       , Ch          , Ch          , Gd^Fdf      , Rr          , Rr          , Gd          , Gd          , Gd          , Gd          , Gd          , Rr          , Rr          , Khr         , Chr         , Ww          , Ww          , Ww          , Wo          , Wo          
Gd^Fdf      , Gd^Fdf      , Gd^Fdf      , Gd^Fdf      , Gd^Fdf      , Gd          , Hhd         , Hhd         , Gd          , Hhd         , Rr          , Rr          , Gd          , Gd          , Hhd         , Hhd         , Hhd         , Rr          , Ch          , Ch          , 3 Kh        , Mm^Xm       , Mm^Xm       , Mm^Xm       , Mm^Xm       , Mm^Xm       , Mm^Xm       , Mm^Xm       , Ch          , Rr          , Gd^Fdf      , Gd          , Gd          , Rr^Vhc      , Gd          , Gd          , Gd^Fdf      , Gd          , Gd          , Rr          , Chr         , Ww          , Ww          , Ww          , Wo          , Wo          
Gd^Fdf      , Gd^Fdf      , Gd^Fdf      , Gd^Fdf      , Gd^Fdf      , Gd          , Gd          , Gd          , Gd          , Rr          , Gd          , Gd          , Gd          , Gd          , Hhd         , Md          , Md          , Hhd         , Md          , Ch          , Mm^Xm       , Mm^Xm       , Mm^Xm       , Mm^Xm       , Mm^Xm       , Mm^Xm       , Mm^Xm       , 1 Kh        , Hhd         , Gd^Fdf      , Gd^Fdf      , Gd          , Gd          , Gd          , Gd          , Gd^Fdf      , Gd^Fdf      , Gd^Fdf      , Gd          , Gd          , Gd^Vh       , Ww          , Ww          , Ww          , Wo          , Wo          
Gd^Fdf      , Gd^Fdf      , Gd^Fdf      , Gd^Fdf      , Gd          , Gd          , Gd          , Ce          , Ke          , Rr          , Gd          , Gd          , Gd          , Gd          , Hhd         , Md          , Md          , Md          , Md          , Mm^Xm       , Mm^Xm       , Mm^Xm       , Mm^Xm       , Mm^Xm       , Mm^Xm       , Mm^Xm       , Mm^Xm       , Ch          , Md          , Hhd         , Hhd^Fdf     , Gd^Fdf      , Gd          , Gd          , Gd          , Gd^Fdf      , Gd          , Gd          , Gd          , Gd          , Hhd         , Ww          , Ww          , Ww          , Wo          , Wo          
Gd^Fdf      , Gd^Fdf      , Gd^Fdf      , Gd^Fdf      , Gd^Fdf      , Gd          , Gd          , Ce          , Ce          , Rr          , Gd          , Gd          , Gd          , Gd          , Hhd         , Md          , Mm^Xm       , Md          , Mm^Xm       , Mm^Xm       , Mm^Xm       , Mm^Xm       , Ch          , 2 Kh        , Ch          , Mm^Xm       , Mm^Xm       , Mm^Xm       , Mm^Xm       , Md          , Hhd         , Hhd^Fdf     , Gd          , Gd          , Gd          , Gd          , Gd          , Gd          , Gd          , Gd          , Gd          , Hhd         , Ww          , Ww          , Wo          , Wo          
Gd^Fdf      , Gd^Fdf      , Gd^Fdf      , Gd^Fdf      , Gd^Fdf      , Gd          , Gd          , Gd          , Gd          , Rr          , Gd          , Gd          , Gd^Fdf      , Gd^Fdf      , Hhd         , Md          , Mm^Xm       , Mm^Xm       , Mm^Xm       , Mm^Xm       , Mm          , Ch          , Hhd^Fdf     , Ch          , Hhd         , Ch          , Md          , Md          , Mm^Xm       , Md          , Md          , Hhd         , Hhd         , Gd          , Gd          , Gd          , Ce          , Ke          , Ce          , Gd          , Gd          , Hhd         , Ww          , Ww          , Wo          , Wo          
Gd^Fdf      , Gd^Fdf      , Gd^Fdf      , Gd^Fdf      , Gd^Fdf      , Gd          , Gd          , Gd          , Gd          , Rr          , Gd          , Gd^Fdf      , Gd^Fdf      , Gd^Fdf      , Hhd^Fdf     , Md          , Mm^Xm       , Md          , Md          , Hhd^Fdf     , Hhd^Fdf     , Hhd^Fdf     , Gd^Fdf      , Rr          , Gd^Fdf      , Hhd^Fdf     , Hhd^Fdf     , Md          , Md          , Mm^Xm       , Mm^Xm       , Md          , Hhd         , Gd          , Gd          , Gd          , Gd          , Ce          , Gd          , Gd          , Gd          , Hhd         , Hhd         , Ww          , Ww          , Wo          
Gd^Fdf      , Gd^Fdf      , Gd^Fdf      , Gd^Fdf      , Gd^Fdf      , Gd^Vh       , Gd          , Gd          , Gd          , Rr          , Gd          , Gd          , Gd^Vhr      , Gd^Fdf      , Hhd^Fdf     , Md          , Mm^Xm       , Mm^Xm       , Hhd^Fdf     , Hhd^Fdf     , Gd^Fdf      , Gd^Fdf      , Gd          , Rr          , Gd^Fdf      , Gd^Fdf      , Hhd^Fdf     , Md          , Md          , Mm^Xm       , Mm^Xm       , Md          , Hhd^Vhh     , Gd          , Gd          , Gd          , Gd          , Gd          , Gd          , Gd          , Gd          , Hhd         , Hhd         , Ww          , Ww          , Wo          
Gd^Fdf      , Gd^Fdf      , Gd^Fdf      , Gd^Fdf      , Gd^Fdf      , Gd^Fdf      , Gd          , Gd          , Gd          , Rr          , Gd          , Gd          , Gd^Fdf      , Gd^Fdf      , Hhd^Fdf     , Md          , Mm          , Hhd^Fdf     , Hhd^Fdf     , Hhd^Fdf     , Gd^Fdf      , Gd^Fdf      , Gd          , Rr          , Gd^Fdf      , Gd^Fdf      , Gd^Fdf      , Hhd         , Md          , Md          , Mm^Xm       , Md          , Md          , Hhd         , Gd^Fdf      , Gd          , Gd          , Gd          , Gd          , Gd          , Gd          , Hhd         , Ww          , Ww          , Wo          , Wo          
Gd^Fdf      , Gd^Fdf      , Gd^Fdf      , Gd^Fdf      , Gd^Fdf      , Gd^Fdf      , Gd          , Gd          , Gd          , Rr          , Gd          , Gd          , Gd^Fdf      , Gd^Fdf      , Gd^Fdf      , Hhd^Fdf     , Hhd^Fdf     , Hhd^Fdf     , Gd^Fdf      , Gd^Fdf      , Gd^Fdf      , Gd          , Rr          , Rr          , Rr          , Gd^Fdf      , Gd^Fdf      , Hhd^Fdf     , Hhd         , Md^Vhh      , Md          , Mm^Xm       , Md          , Hhd^Fdf     , Gd^Fdf      , Gd^Fdf      , Gd          , Gd          , Gd          , Gd          , Gd^Vhr      , Hhd         , Ww          , Ww          , Wo          , Wo          
Ww          , Gd^Fdf      , Gd^Fdf      , Gd^Fdf      , Gd          , Gd          , Gd          , Gd          , Gd          , Rr          , Gd          , Gd          , Gd^Fdf      , Gd^Fdf      , Gd^Fdf      , Gg^Fdf      , Gd^Fdf      , Gd^Fdf      , Gd^Fdf      , Gd^Fdf      , Rr          , Rr          , Rr          , Rr^Vd       , Rr          , Gd^Fdf      , Gd^Fdf      , Gd^Fdf      , Gd^Fdf      , Hhd         , Hhd         , Md          , Hhd^Fdf     , Hhd^Fdf     , Gd^Fdf      , Gd          , Re          , Re          , Re          , Gd          , Hhd         , Hhd         , Ww          , Ww          , Wo          , Wo          
Ww          , Ww          , Ww          , Gd          , Gd          , Gd          , Gd          , Gd          , Gd          , Rr          , Rr          , Gd          , Gd          , Gd^Fdf      , Gd          , Gd^Fdf      , Gd^Fdf      , Gd          , Rr          , Rr          , Gd          , Gd          , Gd          , Rr          , Gd          , Rr          , Rr          , Gd^Fdf      , Gd          , Gd^Fdf      , Gd^Fdf      , Hhd         , Hhd^Fdf     , Hhd^Fdf     , Re          , Re          , Re          , Re          , Re          , Re          , Gd          , Hhd         , Ww          , Ww          , Wo          , Wo          
Ww          , Ww          , Ww          , Ww          , Ww          , Gd          , Gd          , Gd          , Gd          , Gd          , Gd          , Rr          , Rr          , Gd          , Gd          , Gd          , Rr          , Rr          , Gd          , Gd          , Gd          , Gd^Fdf      , Gd^Fdf      , Rr          , Gd^Fdf      , Gd          , Gd          , Rr          , Rr          , Gd          , Gd          , Gd^Fdf      , Gd          , Hhd         , Re          , Re          , Re          , Re          , Re          , Re          , Hhd         , Ww          , Ww          , Ww          , Wo          , Wo          
Wo          , Ww          , Ww          , Ww          , Ww          , Ce          , Ke          , Gd          , Gd          , Gd          , Gd          , Gd          , Gd          , Rr          , Rr          , Rr          , Gd          , Ce          , Ke          , Gd          , Gd          , Gd^Fdf      , Gd          , Rr          , Gd          , Gd^Fdf      , Gd^Fdf      , Gd^Fdf      , Gd^Fdf      , Rr          , Ke          , Ce          , Gd          , Re          , Re          , Re          , Re          , Re          , Hhd^Vhhr    , Hhd         , Wwr         , Ww          , Ww          , Ww          , Wo          , Wo          
Wo          , Wo          , Ww          , Ww          , Ww          , Ce          , Ce          , Gd          , Gd          , Gd          , Gd          , Gd          , Gd          , Gd          , Gd          , Gd          , Gd          , Ce          , Ce          , Gd          , Gd          , Gd          , Gd          , Rr          , Gd          , Gd          , Gd          , Gd          , Gd          , Gd          , Ce          , Ce          , Gd          , Gd          , Gd          , Re          , Re          , Re          , Hhd         , Hhd         , Ww          , Ww          , Ww          , Ww          , Wo          , Wo          
Wo          , Wo          , Ww          , Ww          , Ww          , Ww          , Ww          , Gd          , Ww          , Gd          , Gd          , Gd^Vh       , Gd          , Gd          , Gd          , Gd          , Gd          , Gd          , Gd          , Gd          , Gd^Fdf      , Gd^Fdf      , Gd^Fdf      , Rr          , Gd^Fdf      , Gd^Vh       , Gd^Fdf      , Gd          , Gd          , Gd          , Gd          , Gd          , Gd          , Gd          , Gd^Vh       , Gd          , Hhd         , Hhd         , Wwr         , Wwr         , Ww          , Ww          , Wwr         , Ww          , Wo          , Wo          
Wo          , Wo          , Wo          , Ww          , Ww          , Ww          , Ww          , Ww          , Ww          , Ww          , Ww          , Gd          , Gd          , Gd          , Gd          , Gd          , Gd          , Gd^Vh       , Gd^Fdf      , Gd^Fdf      , Gd^Fdf      , Gd^Fdf      , Chr         , Khr         , Chr         , Gd^Fdf      , Gd^Fdf      , Gd^Fdf      , Gd^Fdf      , Gd          , Gd          , Gd          , Hhd         , Hhd         , Hhd         , Hhd         , Ww          , Wwr         , Ww          , Ww          , Ww          , Wwr         , Hh          , Ds          , Wo          , Wo          
Wo          , Wo          , Wo          , Wo          , Wo          , Ww          , Wo          , Ww          , Ww          , Ww          , Ww          , Ww          , Ww          , Ww          , Ww          , Ww          , Ww          , Gd^Fdf      , Ww          , Gd^Fdf      , Ww          , Chr         , Ww          , Ww          , Ww          , Ww          , Ww          , Ww          , Ww          , Ww          , Ww          , Gd          , Hhd         , Hhd         , Ww          , Ww          , Ww          , Ww          , Ww          , Ww          , Ds          , Hh          , Mm^Vhh      , Ch          , Wo          , Wo          
Wo          , Wo          , Wo          , Wo          , Wo          , Wo          , Wo          , Wo          , Wo          , Ww          , Ww          , Ww          , Ww          , Ww          , Ww          , Ww          , Ww          , Ww          , Ww          , Ww          , Ww          , Ww          , Ww          , Ww          , Ww          , Ww          , Ww          , Ww          , Ww          , Ww          , Ww          , Ww          , Ww          , Ww          , Ww          , Ww          , Ww          , Ww          , Ww          , Ww          , Ww          , Ch          , Ch          , Kh          , Wo          , Wo          
Wo          , Wo          , Wo          , Wo          , Wo          , Wo          , Wo          , Wo          , Wo          , Wo          , Wo          , Ww          , Wo          , Ww          , Wo          , Ww          , Wo          , Ww          , Ww          , Ww          , Ww          , Ww          , Wo          , Ww          , Wo          , Ww          , Wo          , Ww          , Wo          , Ww          , Wo          , Ww          , Ww          , Ww          , Wo          , Wo          , Wo          , Wo          , Wo          , Wo          , Wo          , Wo          , Wo          , Wo          , Wo          , Wo          
Wo          , Wo          , Wo          , Wo          , Wo          , Wo          , Wo          , Wo          , Wo          , Wo          , Wo          , Wo          , Wo          , Wo          , Wo          , Wo          , Wo          , Wo          , Wo          , Wo          , Wo          , Wo          , Wo          , Wo          , Wo          , Wo          , Wo          , Wo          , Wo          , Wo          , Wo          , Wo          , Wo          , Wo          , Wo          , Wo          , Wo          , Wo          , Wo          , Wo          , Wo          , Wo          , Wo          , Wo          , Wo          , Wo          
