border_size=1
usage=map

Wo          , Wo          , Wo          , Wo          , Wo          , Wo          , Wo          , Wo          , Wo          , Wo          , Ww          , Ww          , Ww          , Mm          , Mm          , Mm          , Mm          , Mm          , Mm          , Mm          , Mm          , Mm          , Mm          , Mm          , Mm          , Ww          , Ww          , Ww          , Wo          , Wo          , Wo          , Wo          , Wo          , Ww          , Ww          , Ww          , Gll^Fp      , Hh          , Hh          , Hh          , Mm          , Mm          , Mm          , Mm          , Mm          , Mm          
Wo          , Wo          , Wo          , Wo          , Wo          , Wo          , Wo          , Wo          , Wo          , Wo          , Ww          , Ww          , Ww          , Mm          , Mm          , Mm          , Mm          , Mm          , Mm          , Mm          , Mm          , Mm          , Mm          , Mm          , Mm          , Ww          , Ww          , Ww          , Wo          , Wo          , Wo          , Wo          , Wo          , Ww          , Ww          , Ww          , Gll^Fp      , Gll^Fp      , Hh^Fp       , Hh          , Hh          , Mm          , Mm          , Mm          , Mm          , Mm          
Wo          , Wo          , Wo          , Wo          , Wo          , Wo          , Wo          , Wo          , Wo          , Wo          , Ww          , Ww          , Ww          , Mm          , Mm          , Mm          , Mm          , Mm          , Mm          , Mm          , Mm          , Mm          , Mm          , Mm          , Mm          , Ww          , Ww          , Ww          , Wo          , Wo          , Wo          , Wo          , Wo          , Ww          , Ww          , Ww          , Gll^Fp      , Gll^Fp      , Hh^Fp       , Hh          , Hh          , Mm          , Mm          , Mm          , Mm          , Mm          
Wo          , Wo          , Wo          , Wo          , Wo          , Wo          , Wo          , Wo          , Ww          , Ww          , Ww          , Ww          , Ww          , Mm          , Mm          , Mm          , Hh          , Mm          , Mm          , Mm          , Mm          , Mm          , Mm          , Mm          , Mm          , Ww          , Ww          , Ww          , Wo          , Wo          , Wo          , Wo          , Wo          , Ww          , Ww          , Ww          , Gll^Fp      , Gll^Fp      , Hh^Fp       , Hh^Fp       , Hh          , Hh          , Mm          , Mm          , Mm          , Mm          
Wo          , Wo          , Wo          , Wo          , Wo          , Wo          , Ww          , Ww          , Ww          , Ww          , Ww          , Ww          , Mm          , Mm          , Hh          , Hh          , Hh^Fp       , Hh          , Hh          , Hh          , Hh          , Mm          , Hh          , Mm          , Mm          , Ww          , Ww          , Ww          , Wo          , Wo          , Wo          , Wo          , Wo          , Ww          , Ww          , Ww          , Gll^Fp      , Hh^Fp       , Hh^Fp       , Hh^Fp       , Hh^Vhh      , Hh          , Hh          , Mm          , Mm          , Mm          
Wo          , Wo          , Wo          , Wo          , Wo          , Ww          , Ww          , Ww          , Ww          , Ww          , Mm          , Mm          , Mm          , Mm          , Hh          , Hh^Fp       , Hh^Fp       , Hh^Fp       , Hh^Fp       , Hh^Fp       , Hh          , Hh          , Hh^Vhh      , Hh          , Ww          , Ww          , Ww          , Ww          , Wo          , Wo          , Wo          , Wo          , Wo          , Ww          , Ww          , Ww          , Gll^Fp      , Gll^Fp      , Gll^Fp      , Hh          , Hh          , Hh          , Hh          , Mm          , Mm          , Mm          
Ww          , Wo          , Wo          , Wo          , Ww          , Ww          , Ww          , Ww          , Mm          , Mm          , Mm          , Mm          , Hh          , Hh          , Hh          , Hh^Fp       , Gll^Fp      , Gll^Fp      , Gll^Fp      , Hh^Fp       , Hh          , Hh          , Hh          , Hh          , Ww          , Ww          , Ww          , Ww^Vm       , Wo          , Wo          , Wo          , Wo          , Wo          , Ww          , Ww          , Ww          , Gll^Fp      , Gll^Fp      , Rb          , Rb          , Gll^Fp      , Hh^Fp       , Hh          , Mm          , Mm          , Mm          
Ww          , Ww          , Ww          , Ww          , Ww          , Ww          , Mm          , Mm          , Mm          , Mm          , Hh          , Hh          , Hh          , Hh          , Hh          , Gll^Fp      , Gg          , Gll^Fp      , Gg          , Gg          , Gg          , Hh          , Cv          , Cv          , Cv          , Ww          , Ww          , Ww          , Ww          , Wo          , Wo          , Wo          , Wo          , Ww          , Ww          , Ww          , Cv          , Cv          , Cv          , Gll^Fp      , Gll^Fp      , Hh^Fp       , Hh^Fp       , Hh          , Mm          , Mm          
Ww          , Ww          , Ww          , Ww          , Ww          , Ww          , Mm          , Mm          , Mm          , Hh          , Hh          , Hh          , Hh          , Hh          , Gg          , Gg          , Gg          , Gg          , Gg          , Gg          , Gg          , Gg          , Cv          , 3 Kv        , Cv          , Ww          , Ww          , Ww          , Ww          , Ww          , Ww          , Wo          , Ww          , Ww          , Ww          , Ww          , Cv          , 2 Kv        , Cv          , Gll^Fp      , Gll^Fp      , Hh^Fp       , Hh^Fp       , Hh          , Mm          , Mm          
Mm          , Ww          , Ww          , Ww          , Mm          , Mm          , Mm          , Mm          , Hh          , Hh          , Hh          , Hh^Vhh      , Gg          , Gg          , Gg          , Gg          , Gg          , Gg          , Gg          , Gg          , Rp          , Rp          , Gg          , Cv          , Ww          , Ww          , Ww          , Ww          , Ww          , Ww          , Ww          , Ww          , Ww          , Ww^Vm       , Ww          , Ww          , Gg          , Cv          , Gg          , Gll^Fp      , Gll^Fp      , Hh^Fp       , Hh          , Hh          , Mm          , Mm          
Mm          , Mm          , Mm          , Mm          , Mm          , Mm          , Hh          , Hh          , Hh          , Hh          , Hh          , Gg          , Gg          , Gg          , Gg          , Gg          , Gg          , Gg          , Rp          , Rp          , Gg          , Gg          , Ww          , Ww          , Ww          , Ww          , Ww          , Ww          , Ww          , Ww          , Ww          , Ww          , Ww          , Ww          , Ww          , Ww          , Gg          , Rp          , Gg          , Gg          , Gg          , Hh          , Hh          , Mm          , Mm          , Mm          
Mm          , Mm          , Mm          , Mm          , Hh          , Hh          , Hh^Fp       , Hh^Fp       , Hh^Fp       , Hh          , Gg          , Gg          , Gg          , Gg          , Gg          , Gg          , Rp          , Rp          , Gg          , Gg          , Ww          , Ww          , Ww          , Ww          , Ww          , Ww          , Ww          , Ww          , Wo          , Ww          , Ww          , Ww          , Ww          , Ww          , Ww          , Gg          , Gg          , Rp          , Gg          , Gg          , Gg          , Hh          , Hh          , Mm          , Mm          , Mm          
Mm          , Mm          , Hh          , Hh          , Hh          , Hh^Fp       , Hh^Fp       , Hh^Fp       , Gll^Fp      , Gg          , Gg          , Gg          , Gg          , Gg          , Rp          , Rp          , Gg          , Gg          , Gg          , Gg          , Ww          , Ww          , Ww          , Ww          , Hh          , Co          , Ww          , Wo          , Wo          , Wo          , Ww          , Ww          , Ww          , Ww          , Gg          , Gg          , Gg          , Rp          , Gg          , Gg          , Gg          , Hh          , Hh          , Mm          , Mm          , Mm          
Mm          , Mm          , Hh          , Hh^Fp       , Hh^Fp       , Hh^Fp       , Gll^Fp      , Co          , Gg          , Gg          , Gg          , Gg          , Rp          , Rp          , Gg          , Gg          , Gg          , Gs^Vh       , Rb          , Wwf         , Ww          , Ww          , Mm          , Mm          , Gll^Fp      , Gg^Ve       , Wo          , Wo          , Wo          , Wo          , Ww          , Ww          , Ww          , Ww          , Gg          , Gg          , Gg          , Rp          , Gg          , Gg          , Gg          , Hh^Vhh      , Hh          , Hh          , Mm          , Mm          
Mm          , Mm          , Hh          , Hh^Fp       , Hh^Fp       , Gll^Fp      , Gll^Fp      , Gg          , Gg          , Gg          , Rp          , Rp          , Gg          , Gg          , Gg          , Gg          , Gll^Fp      , Gll^Fp      , Wwf         , Wwf         , Ww          , Ww          , Gll^Fp      , Mm          , Wo          , Wo          , Wo          , Wo          , Wo          , Wo          , Ww          , Ww          , Ww          , Gg          , Gs^Vh       , Gg          , Gg          , Rp          , Gg          , Gg          , Gg          , Hh          , Hh^Fp       , Hh          , Mm          , Mm          
Mm          , Mm          , Hh          , Hh^Fp       , Hh^Fp       , Gll^Fp      , Gg          , Gg          , Rp          , Rp          , Gg          , Gg          , Gg          , Gg          , Gll^Fp      , Gll^Fp      , Ww          , Ww          , Wwr         , Wwf         , Ww          , Ww          , Wo          , Wo          , Wo          , Wo          , Wo          , Wo          , Ww          , Ww          , Ww          , Ww          , Gg          , Gg          , Gg          , Gg          , Gg          , Rp          , Gg          , Gg          , Gg          , Hh^Fp       , Hh^Fp       , Hh          , Mm          , Mm          
Mm          , Mm          , Hh          , Hh          , Hh          , Gs^Vh       , Gg          , Rp          , Gg          , Gg          , Gg          , Gg          , Gg          , Co          , Gll^Fp      , Gll^Fp      , Ww          , Ww          , Wwr         , Rb          , Ww          , Wo          , Wo          , Wo          , Wo          , Wo          , Ww          , Ww          , Ww          , Ww          , Wwf         , Rb          , Gg          , Gg          , Gg          , Gg          , Gg          , Rp          , Gg          , Gg          , Gg          , Gll^Fp      , Hh^Fp       , Hh          , Mm          , Mm          
Mm          , Mm          , Hh          , Hh          , Hh          , Gg          , Gg          , Rp          , Gg          , Gg          , Gg          , Gg          , Gg          , Gll^Fp      , Gll^Fp      , Ww          , Wwr         , Wwr         , Rb          , Ko          , Ww          , Wo          , Wo          , Wo          , Ww          , Ww          , Rb          , Co          , Wwf         , Wwf         , Gll^Fp      , Gll^Fp      , Gg          , Gg          , Gg          , Gg          , Rp          , Rp          , Gg          , Gg          , Gg          , Gll^Fp      , Hh^Fp       , Hh          , Mm          , Mm          
Mm          , Mm          , Hh          , Hh          , Co          , Gg          , Gg          , Rp          , Gg          , Gg          , Gg          , Gg          , Gg          , Gll^Fp      , Gll^Fp      , Ww          , Wwr         , Rb          , Rb          , Ww          , Wo          , Wo          , Ww          , Ww          , Rb          , Rb          , Wwr         , Wwf         , Wwf         , Gll^Fp      , Gll^Fp      , Gll^Fp      , Gg          , Gg          , Gg          , Rp          , Gg          , Gg          , Gg          , Gg          , Gg          , Hh^Fp       , Hh          , Hh          , Mm          , Mm          
Mm          , Mm          , Hh          , Hh          , Gg          , Gg          , Gg          , Rp          , Gg          , Gg          , Gg          , Gg          , Gg          , Gll^Fp      , Wwf         , Ww          , Wwf         , Co          , Ww          , Ww          , Wo          , Wo          , Ww          , Rb          , Rb          , Wwr         , Ww          , Ww          , Gll^Fp      , Gll^Fp      , Gll^Fp      , Gg          , Gg          , Gg          , Gg          , Rp          , Gg          , Gg          , Gg          , Gg          , Hh^Vhh      , Hh^Fp       , Hh          , Mm          , Mm          , Mm          
Mm          , Mm          , Hh          , Hh          , Gg          , Gg          , Gg          , Rp          , Gg          , Gg          , Gg          , Gg          , Gg          , Gll^Fp      , Wwf         , Wwf         , Ww          , Ww          , Wo          , Wo          , Wo          , Wo          , Ww          , Rb          , Wwr         , Wwr         , Ww          , Ww          , Gll^Fp      , Gll^Fp      , Gg          , Gg          , Gg          , Gg          , Gg          , Rp          , Gg          , Gg          , Gg          , Gg          , Hh^Fp       , Hh^Fp       , Hh          , Mm          , Mm          , Mm          
Mm          , Mm          , Hh          , Hh          , Gg          , Gg          , Gg          , Rp          , Gg          , Gg          , Gs^Vh       , Gg          , Gg          , Wwf         , Ww          , Ww          , Wo          , Wo          , Wo          , Wo          , Wo          , Wo          , Ww          , Ko          , Wwf         , Ww          , Gll^Fp      , Gll^Fp      , Co          , Gg          , Gg          , Gg          , Gg          , Gg          , Rp          , Rp          , Gg          , Gg          , Gll^Fp      , Gll^Fp      , Hh^Fp       , Hh^Fp       , Mm          , Mm          , Mm          , Mm          
Mm          , Mm          , Hh          , Hh          , Gg          , Gg          , Gg          , Rp          , Gg          , Gg          , Gg          , Gg          , Ww          , Ww          , Ww          , Ww          , Wo          , Wo          , Wo          , Wo          , Gll^Fp      , Wo          , Ww          , Wwf         , Rb          , Gll^Fp      , Hh^Fp       , Hh^Fp       , Gg          , Gg          , Gg          , Gg          , Rp          , Rp          , Gg          , Gg          , Gg          , Co          , Gll^Fp      , Gll^Fp      , Hh          , Hh          , Mm          , Mm          , Mm          , Mm          
Mm          , Mm          , Hh          , Hh          , Hh^Vhh      , Gg          , Gg          , Rp          , Gg          , Gg          , Gg          , Ww          , Ww          , Ww          , Wo          , Wo          , Wo          , Wo          , Mm          , Hh          , Gll^Fp      , Ww          , Ww          , Wwf         , Rb          , Hh^Fp       , Hh          , Gg          , Gg          , Gg          , Rp          , Rp          , Gg          , Gg          , Gg          , Gg          , Gll^Fp      , Gll^Fp      , Hh^Fp       , Hh          , Mm          , Mm          , Mm          , Mm          , Mm          , Mm          
Mm          , Mm          , Hh          , Hh          , Hh          , Gg          , Gg          , Rp          , Gg          , Gg          , Gg          , Ww          , Ww          , Ww          , Wo          , Wo          , Wo          , Mm          , Mm          , Gg^Ve       , Ww          , Ww          , Ww          , Wwf         , Rb          , Hh^Fp       , Gs^Vh       , Gg          , Gg          , Gg          , Rp          , Gg          , Gg          , Gg          , Gg          , Gll^Fp      , Hh^Fp       , Hh^Fp       , Mm          , Mm          , Mm          , Mm          , Mm          , Mm          , Ww          , Mm          
Mm          , Mm          , Hh          , Hh          , Hh          , Gg          , Gg          , Rp          , Gg          , Gg          , Ww          , Ww          , Ww          , Ww          , Ww          , Wo          , Wo          , Wo          , Wo          , Co          , Ww          , Ww          , Ww          , Rb          , Gg          , Gg          , Gg          , Gg          , Gg          , Gg          , Rp          , Gg          , Gg          , Gg          , Gll^Fp      , Gll^Fp      , Hh^Fp       , Hh          , Mm          , Mm          , Mm          , Mm          , Ww          , Ww          , Ww          , Ww          
Mm          , Hh          , Hh          , Hh          , Hh          , Gg          , Gg          , Rp          , Gg          , Ww          , Ww          , Ww          , Ww^Vm       , Ww          , Ww          , Ww          , Ww          , Wo          , Wo          , Ww          , Ww          , Ww          , Ww          , Gg          , Gg          , Gg          , Gg          , Gg          , Rp          , Rp          , Gg          , Gg          , Gg          , Gs^Vh       , Gll^Fp      , Gll^Fp      , Hh          , Hh          , Mm          , Mm          , Ww          , Ww          , Ww          , Ww          , Ww          , Ww          
Mm          , Mm          , Mm          , Hh          , Hh          , Hh          , Cv          , Cv          , Cv          , Ww          , Ww          , Ww          , Ww          , Ww          , Ww          , Ww          , Ww          , Ww          , Ww          , Ww          , Ww          , Ww          , Gg          , Gg          , Gg          , Gg          , Rp          , Rp          , Gg          , Gg          , Gg          , Gg          , Gll^Fp      , Gll^Fp      , Hh          , Hh          , Mm          , Mm          , Mm          , Mm          , Ww          , Ww          , Ww          , Ww          , Wo          , Wo          
Mm          , Mm          , Mm          , Hh          , Hh          , Hh          , Cv          , 1 Kv        , Cv          , Ww          , Ww          , Ww          , Wo          , Ww          , Ww          , Ww          , Ww          , Ww          , Ww          , Ww          , Ww          , Ww          , Gg          , Gg          , Rp          , Rp          , Gg          , Gg          , Gg          , Gg          , Co          , Gll^Fp      , Hh^Fp       , Hh^Fp       , Hh          , Mm          , Mm          , Mm          , Ww          , Ww          , Ww          , Ww          , Wo          , Wo          , Wo          , Wo          
Mm          , Mm          , Mm          , Hh          , Hh          , Hh          , Hh          , Cv          , Ww          , Ww          , Ww          , Ww          , Wo          , Wo          , Wo          , Ww          , Ww          , Ww          , Ww          , Ww          , Cv          , Cv          , Cv          , Rp          , Gg          , Gg          , Gg          , Gg          , Gll^Fp      , Gll^Fp      , Hh          , Hh          , Hh          , Hh^Fp       , Hh          , Mm          , Mm          , Mm          , Ww          , Ww          , Ww          , Wo          , Wo          , Wo          , Wo          , Wo          
Mm          , Mm          , Mm          , Hh          , Hh          , Hh^Vhh      , Hh          , Hh          , Ww          , Ww          , Ww          , Wo          , Wo          , Wo          , Wo          , Wo          , Wo          , Ww^Vm       , Ww          , Ww          , Cv          , 4 Kv        , Cv          , Gg          , Gg          , Gg          , Gg          , Gll^Fp      , Hh^Fp       , Hh^Fp       , Hh          , Hh          , Hh          , Hh          , Mm          , Mm          , Mm          , Mm          , Ww          , Ww          , Ww          , Wo          , Wo          , Wo          , Wo          , Wo          
Mm          , Mm          , Mm          , Mm          , Mm          , Hh          , Hh          , Hh          , Ww          , Ww          , Wo          , Wo          , Wo          , Wo          , Wo          , Wo          , Wo          , Ww          , Ww          , Ww          , Hh          , Cv          , Hh          , Gg          , Gg          , Gg          , Hh          , Hh^Fp       , Hh^Fp       , Hh^Fp       , Hh          , Hh          , Mm          , Mm          , Mm          , Mm          , Ww          , Ww          , Ww          , Ww          , Ww          , Wo          , Wo          , Wo          , Wo          , Wo          
Mm          , Mm          , Mm          , Mm          , Mm          , Hh          , Ww          , Ww          , Ww          , Ww          , Wo          , Wo          , Wo          , Wo          , Wo          , Wo          , Ww          , Ww          , Ww          , Ww          , Hh          , Hh          , Hh          , Hh          , Hh          , Hh^Vhh      , Hh          , Hh          , Hh          , Hh          , Mm          , Mm          , Mm          , Mm          , Mm          , Mm          , Ww          , Ww          , Ww          , Ww          , Wo          , Wo          , Wo          , Wo          , Wo          , Wo          
Hh          , Hh          , Hh          , Mm          , Hh          , Hh          , Ww          , Ww          , Ww          , Wo          , Wo          , Wo          , Wo          , Wo          , Wo          , Ww          , Ww          , Ww          , Ww          , Hh          , Mm          , Mm          , Mm          , Hh          , Mm          , Hh          , Mm          , Hh          , Mm          , Mm          , Mm          , Mm          , Mm          , Mm          , Mm          , Ww          , Ww          , Ww          , Wo          , Wo          , Wo          , Wo          , Wo          , Wo          , Wo          , Wo          
Hh          , Hh          , Hh          , Hh          , Hh          , Hh          , Ww          , Ww          , Ww          , Wo          , Wo          , Wo          , Wo          , Wo          , Wo          , Ww          , Ww          , Ww          , Ww          , Hh          , Mm          , Mm          , Mm          , Mm          , Mm          , Mm          , Mm          , Mm          , Mm          , Mm          , Mm          , Mm          , Mm          , Mm          , Mm          , Ww          , Ww          , Ww          , Wo          , Wo          , Wo          , Wo          , Wo          , Wo          , Wo          , Wo          
